Wo, Wo, Wo, Wo, Wo, Wo, Wo, Wo, Wo, Wo, Wo, Wo, Wo, Wo, Wo, Wo, Wo, Wo, Wo, Wo, Wo, Wo, Wo, Wo, Wo, Wo, Wo, Wo, Wo, Wo, Wo, Wo, Wo, Wo, Wo, Wo, Wo, Wo, Wo, Wo, Wo, Wo, Wo, Wo, Wo, Wo, Wo, Wo, Wo, Wo, Wo, Wo
Wo, Wo, Wo, Wo, Wo, Wo, Wo, Wo, Wo, Wo, Wo, Wo, Wo, Wo, Wo, Wo, Wo, Wo, Wo, Wo, Wo, Wo, Wo, Wo, Wo, Wo, Wo, Wo, Wo, Wo, Wo, Wo, Wo, Wo, Wo, Wo, Wo, Wo, Wo, Wo, Wo, Wo, Wo, Wo, Wo, Wo, Wo, Wo, Wo, Wo, Wo, Wo
Wo, Wo, Wo, Wo, Wo, Wo, Wo, Wo, Wo, Wo, Wo, Wo, Wo, Wo, Wo, Wo, Wo, Wo, Wo, Wo, Wo, Wo, Wo, Wo, Wo, Wo, Wo, Wo, Wo, Wo, Wo, Wo, Wo, Wo, Wo, Wo, Wo, Wo, Wo, Wo, Wo, Wo, Wo, Wo, Wo, Wo, Wo, Wo, Wo, Wo, Wo, Wo
Wo, Wo, Wo, Wo, Wo, Wo, Wo, Wo, Wo, Wo, Wo, Wo, Wo, Wo, Wo, Wo, Wo, Wo, Wo, Wo, Wo, Wo, Wo, Wo, Wo, Wo, Wo, Wo, Wo, Wo, Wo, Wo, Wo, Wo, Wo, Wo, Wo, Wo, Wo, Wo, Wo, Wo, Wo, Wo, Wo, Wo, Wo, Wo, Wo, Wo, Wo, Wo
Wo, Wo, Wo, Wo, Wo, Wo, Wo, Wo, Wo, Wo, Wo, Wo, Wo, Wo, Wo, Wo, Wo, Wo, Wo, Wo, Wo, Wo, Wo, Wo, Wo, Wo, Wo, Wo, Wo, Wo, Wo, Wo, Wo, Wo, Gg, Wo, Wo, Wo, Wo, Wo, Wo, Wo, Wo, Wo, Wo, Wo, Wo, Wo, Wo, Wo, Wo, Wo
Wo, Wo, Wo, Wo, Wo, Wo, Wo, Wo, Wo, Wo, Wo, Wo, Wo, Wo, Wo, Wo, Wo, Wo, Wo, Wo, Wo, Wo, Wo, Wo, Wo, Wo, Gg, Wo, Gg, Gg, Hh, Gg, Gg, Gg, Gg, Wo, Wo, Wo, Wo, Wo, Wo, Wo, Wo, Wo, Wo, Wo, Wo, Wo, Wo, Wo, Wo, Wo
Wo, Wo, Wo, Wo, Wo, Wo, Wo, Wo, Wo, Wo, Wo, Wo, Wo, Wo, Wo, Wo, Wo, Wo, Wo, Wo, Wo, Wo, Wo, Wo, Wo, Gg, Hh, Hh, Mm, Hh, Hh, Hh, Gg, Gg, Wo, Wo, Wo, Wo, Wo, Wo, Wo, Wo, Wo, Wo, Wo, Wo, Wo, Wo, Wo, Wo, Wo, Wo
Wo, Wo, Wo, Wo, Wo, Wo, Wo, Wo, Wo, Wo, Wo, Wo, Wo, Wo, Wo, Wo, Wo, Wo, Wo, Wo, Wo, Wo, Wo, Wo, Gg, Hh, Mm, Hh, Hh, Hh, Hh, Hh, Wo, Wo, Wo, Wo, Wo, Wo, Wo, Wo, Wo, Wo, Wo, Wo, Wo, Wo, Wo, Wo, Wo, Wo, Wo, Wo
Wo, Wo, Wo, Wo, Wo, Wo, Wo, Wo, Wo, Wo, Wo, Wo, Wo, Wo, Wo, Wo, Wo, Wo, Wo, Wo, Wo, Wo, Wo, Wo, Hh, Hh, Mm, Mm, Gg, Hh, Gg, Hh, Wo, Wo, Wo, Wo, Wo, Wo, Wo, Wo, Wo, Wo, Wo, Wo, Wo, Wo, Wo, Wo, Wo, Wo, Wo, Wo
Wo, Wo, Wo, Wo, Wo, Wo, Wo, Wo, Wo, Wo, Wo, Wo, Wo, Wo, Wo, Wo, Wo, Wo, Wo, Wo, Wo, Wo, Wo, Hh, Mm, Mm, Hh, Mm, Hh, Hh, Gg, Wo, Wo, Wo, Gg, Wo, Gg, Wo, Gg, Wo, Wo, Wo, Wo, Wo, Wo, Wo, Wo, Wo, Wo, Wo, Wo, Wo
Wo, Wo, Wo, Wo, Wo, Wo, Wo, Wo, Wo, Wo, Wo, Wo, Wo, Wo, Wo, Wo, Wo, Wo, Wo, Wo, Wo, Wo, Hh, Hh, Hh, Hh, Gg, Hh, Ch, Gg, Gg, Wwg, Gg, Gg, Hh, Gs^Fms, Hh, Gg, Hh, Gg, Gg, Wo, Wo, Wo, Wo, Wo, Wo, Wo, Wo, Wo, Wo, Wo
Wo, Wo, Wo, Wo, Wo, Wo, Wo, Wo, Wo, Wo, Wo, Wo, Wo, Wo, Wo, Wo, Wo, Wo, Wo, Wo, Wo, Hh, Hh, Hh, Gs^Fms, Gs^Fms, Gg, Ch, 2 Kh, Gg, Wwg, Wwg, Hh, Hh, Mm, Hh, Mm, Hh, Hh, Hh, Gg, Gg, Wo, Wo, Wo, Wo, Wo, Wo, Wo, Wo, Wo, Wo
Wo, Wo, Wo, Wo, Wo, Wo, Wo, Wo, Wo, Wo, Wo, Wo, Wo, Wo, Wo, Wo, Wo, Wo, Wo, Wo, Gg, Hh, Gg, Gg, Gs^Fms, Gs^Fms, Rrc, Rrc, Wwg, Wwg^Bsb\, Rrc, Hh, Hh, Mm, Mm, Mm, Hh, Hh, Rr^Vhc, Hh, Gg, Wo, Wo, Wo, Wo, Wo, Wo, Wo, Wo, Wo, Wo, Wo
Wo, Wo, Wo, Wo, Wo, Wo, Wo, Wo, Wo, Wo, Wo, Wo, Wo, Wo, Wo, Wo, Wo, Wo, Wo, Wo, Gg, Gg, Gg, Gg, Hh, Gg, Rrc, Wwg, Wwg, Hh, Hh, Rrc, Rrc, Hh, Hh, Hh, Hh, Rr^Vhc, Rr^Vhc, Gg, Wo, Wo, Wo, Wo, Wo, Wo, Wo, Wo, Wo, Wo, Wo, Wo
Wo, Wo, Wo, Wo, Wo, Wo, Wo, Wo, Wo, Wo, Wo, Wo, Wo, Wo, Wo, Wo, Wo, Wo, Gg, Gg, Wo, Gg, Gg, Gg, Hh, Rrc, Wwg, Wwg, Hh, Mm, Mm, Hh, Rrc, Hh, Gg, Hh, Gg, Gg, Wo, Wo, Wo, Wo, Wo, Wo, Wo, Wo, Wo, Wo, Wo, Wo, Wo, Wo
Wo, Wo, Wo, Wo, Wo, Wo, Wo, Wo, Wo, Wo, Wo, Wo, Wo, Wo, Wo, Wo, Wo, Gg, Wo, Wo, Wo, Wo, Hh, Hh, Rrc, Rrc, Wwg, Hh, Hh, Mm, Hh, Hh, Hh, Rrc, Gg, Gg, Wo, Wo, Wo, Wo, Wo, Wo, Wo, Wo, Wo, Wo, Wo, Wo, Wo, Wo, Wo, Wo
Wo, Wo, Wo, Wo, Wo, Wo, Wo, Wo, Wo, Wo, Wo, Wo, Wo, Wo, Wo, Wo, Wo, Wo, Wo, Wo, Gg, Gg, Hh, Rr^Vhc, Wwg^Bsb\, Wwg, Gg, Hh, Gg, Hh, Gg, Gs^Fms, Gg, Rrc, Rr^Vhc, Gg, Gg, Wo, Gg, Wo, Wo, Wo, Wo, Wo, Wo, Wo, Wo, Wo, Wo, Wo, Wo, Wo
Wo, Wo, Wo, Wo, Wo, Wo, Wo, Wo, Wo, Wo, Wo, Wo, Wo, Wo, Wo, Wo, Wo, Wo, Wo, Wo, Gg, Hh, Hh, Rr^Vhc, Wwg^Bsb\, Rr^Vhc, Rrc, Hh, Rrc, Hh, Rrc, Gs^Fms, Rrc, Rr^Vhc, Rr^Vhc, Rr^Vhc, Rrc, Gg, Gg, Wo, Wo, Wo, Wo, Wo, Wo, Wo, Wo, Wo, Wo, Wo, Wo, Wo
Wo, Wo, Wo, Wo, Wo, Wo, Wo, Wo, Wo, Wo, Wo, Wo, Wo, Wo, Wo, Wo, Wo, Wo, Gg, Gg, Gg, Gg, Wo, Wo, Rr^Vhc, Rr^Vhc, Hh, Rrc, Hh, Rrc, Hh, Rrc, Hh, Hh, Rr^Vhc, Rr^Vhc, Hh, Rrc, Rrc, Gg, Gg, Wo, Wo, Wo, Wo, Wo, Wo, Wo, Wo, Wo, Wo, Wo
Wo, Wo, Wo, Wo, Wo, Wo, Wo, Wo, Wo, Wo, Wo, Wo, Wo, Wo, Wo, Wo, Gg, Gg, Wo, Gg, Wo, Wo, Wo, Gg, Gg, Rr^Vhc, Rrc, Hh, Hh, Hh, Hh, Hh, Mm, Hh, Hh, Hh, Hh, Gg, Gg, Rrc, Gg, Wo, Wo, Wo, Wo, Wo, Wo, Wo, Wo, Wo, Wo, Wo
Wo, Wo, Wo, Wo, Wo, Wo, Wo, Wo, Wo, Wo, Wo, Wo, Wo, Wo, Wo, Wo, Wo, Wo, Gg, Wo, Wo, Wo, Wo, Gg, Gg, Hh, Hh, Rrc, Hh, Hh, Hh, Mm, Mm, Mm, Hh, Hh, Hh, Hh, Hh, Rrc, Rrc, Gg, Wo, Wo, Wo, Wo, Wo, Wo, Wo, Wo, Wo, Wo
Wo, Wo, Wo, Wo, Wo, Wo, Wo, Wo, Wo, Wo, Wo, Wo, Wo, Wo, Wo, Wo, Wo, Wo, Wo, Wo, Wo, Wo, Hh, Hh, Hh, Hh, Mm, Rrc, Rrc, Hh, Hh, Mm, Mm, Mm, Mm, Mm, Mm, Hh, Hh, Gg, Rrc, Gg, Gg, Wo, Wo, Wo, Wo, Wo, Wo, Wo, Wo, Wo
Wo, Wo, Wo, Wo, Wo, Wo, Gg, Gg, Gg, Gg, Gg, Wo, Wo, Wo, Wo, Wo, Wo, Wo, Wo, Wo, Wo, Gg, Hh, Mm, Mm, Mm, Mm, Hh, Hh, Rrc, Hh, Hh, Hh, Mm, Mm, Mm, Mm, Hh, Hh, Hh, Hh, Rrc, Gg, Wo, Wo, Wo, Wo, Wo, Wo, Wo, Wo, Wo
Wo, Wo, Wo, Wo, Gg, Gg, Gg, Hh, Hh, Gg, Gg, Gg, Gg, Wo, Wo, Wo, Wo, Wo, Wo, Wo, Gg, Gg, Gg, Hh, Hh, Mm, Mm, Hh, Hh, Rrc, Rrc, Hh, Hh, Mm, Hh, Mm, Hh, Hh, Hh, Hh, Hh, Rrc, Gg, Gg, Wo, Wo, Wo, Wo, Wo, Wo, Wo, Wo
Wo, Wo, Wo, Gg, Gg, Gg, Gg, Hh, Hh, Gg, Gg, Gg, Gg, Gg, Wo, Wo, Wo, Wo, Wo, Gg, Gg, Gg, Hh, Hh, Hh, Hh, Hh, Hh, Hh, Hh, Rrc, Hh, Hh, Hh, Hh, Hh, Hh, Hh, Hh, Hh, Hh, Rrc, Rrc, Gg, Wo, Wo, Wo, Wo, Wo, Wo, Wo, Wo
Wo, Wo, Wo, Wo, Wo, Gg, Gg, Gg, Hh, Gg, Gg, Hh, Gg, Gg, Wo, Wo, Wo, Wo, Gg, Gg, Gg, Gg, Hh, Gg, Gg, Gg, Gg, Hh, Gg, Hh, Hh, Rrc, Hh, Hh, Hh, Hh, Hh, Hh, Hh, Hh, Hh, Gg, Rrc, Gg, Wo, Wo, Wo, Wo, Wo, Wo, Wo, Wo
Gg, Wo, Gg, Wo, Gg, Gg, Gg, Gg, Gg, Gg, Hh, Hh, Gg, Gg, Wo, Wo, Wo, Wo, Gg, Gg, Gg, Gg, Gg, Gg, Gg, Gg, Wo, Gg, Gg, Gg, Gs^Fms, Rrc, Rrc, Hh, Rrc, Rrc, Rrc, Rrc, Rrc, Rrc, Rrc, Rrc, Rrc, Gg, Rr^Vhc, Wo, Wo, Wo, Wo, Wo, Wo, Wo
Gg, Gg, Gg, Hh, Hh, Gg, Hh, Hh, Gg, Gg, Hh, Gg, Gg, Gg, Wwt, Wwt, Wwt, Wwt, Gg, Gg, Wo, Gg, Wo, Gg, Wo, Wo, Wo, Wo, Gg, Gs^Fms, Gs^Fms, Gg, Rr^Vhc, Rr^Vhc, Rr^Vhc, Rrc, Rrc, Gg, Gs^Fms, Gs^Fms, Gg, Gg, Rrc, Rr^Vhc, Rr^Vhc, Wo, Gg, Wo, Wo, Wo, Wo, Wo
Wo, Gg, Gg, Hh, Hh, Gg, Gg, Gg, Gg, Gg, Rr^Vhc, Rr^Vhc, Rr^Vhc, Gg, Wo, Wo, Wo, Wo, Wo, Wo, Wo, Wo, Wo, Wo, Wo, Wo, Wo, Wo, Gg, Gs^Fms, Gg, Gg, Hh, Rr^Vhc, Hh, Gg, Gg, Rrc, Rrc, Gg, Rr^Vhc, Rrc, Gg, Rr^Vhc, Gg, Gg, Gs^Fms, Gg, Gg, Wo, Wo, Wo
Wo, Wo, Gg, Gg, Gg, Gg, Gg, Gg, Gg, Rr^Vhc, Rr^Vhc, Rr^Vhc, Rr^Vhc, Wo, Wo, Wo, Wo, Wo, Wo, Wo, Wo, Wo, Wo, Wo, Wo, Wo, Wo, Wo, Wo, Gg, Gg, Gg, Hh, Hh, Hh, Hh, Hh, Hh, Gg, Rr^Vhc, Rr^Vhc, Gg, Gg, Rrc, Rrc, Gg, Gs^Fms, Gs^Fms, Gs^Fms, Wo, Wo, Wo
Gg, Gg, Gg, Gg, Hh, Gg, Gg, Gg, Gg, Gg, Rr^Vhc, Rr^Vhc, Rr^Vhc, Wo, Wo, Wo, Wo, Wo, Gg, Wo, Wo, Wo, Wo, Wo, Wo, Wo, Wo, Wo, Wo, Wo, Gg, Gg, Hh, Hh, Hh, Hh, Hh, Hh, Hh, Rr^Vhc, Gs^Fms, Rrc, Rrc, Gg, Rrc, Gg, Rr^Vhc, Gs^Fms, Gs^Fms, Gg, Wo, Wo
Gg, Gg, Gg, Hh, Hh, Gg, Gg, Gg, Gg, Gg, Gg, Gg, Gg, Wo, Wo, Wo, Wo, Gg, Gg, Gg, Wo, Wo, Wo, Wo, Wo, Wo, Wo, Wo, Wo, Wo, Wo, Hh, Hh, Hh, Hh, Hh, Hh, Hh, Hh, Hh, Gs^Fms, Gs^Fms, Gs^Fms, Rrc, Rrc, Rr^Vhc, Rr^Vhc, Gg, Gs^Fms, Gg, Gg, Wo
Gg, Gg, Gg, Gg, Gg, Gg, Gg, Gg, Gg, Gg, Gg, Gg, Gg, Wo, Wo, Wo, Gg, Gg, Gg, Gg, Wo, Wo, Wo, Wo, Wo, Wo, Wo, Wo, Wo, Wo, Wo, Gg, Hh, Hh, Hh, Hh, Hh, Hh, Hh, Hh, Gs^Fms, Gs^Fms, Gs^Fms, Gs^Fms, Rrc, Rr^Vhc, Rrc, Gg, Gg, Gg, Gg, Wo
Wo, Gg, Gg, Gg, Gg, Gg, Gg, Gg, Gg, Gg, Gg, Gg, Gg, Wo, Wo, Wo, Wo, Gg, Wo, Wo, Wo, Wo, Wo, Wo, Wo, Wo, Wo, Wo, Wo, Wo, Wo, Gg, Gg, Hh, Hh, Hh, Hh, Hh, Hh, Hh, Rrc, Gs^Fms, Rrc, Rrc, Gg, Gg, Rrc, Gg, Ww, Ww, Ww, Wo
Wo, Wo, Gg, Hh, Hh, Gg, Hh, Gg, Gg, Gg, Gg, Gg, Gg, Wo, Wo, Wo, Wo, Wo, Wo, Wo, Wo, Wo, Wo, Wo, Wo, Wo, Wo, Wo, Wo, Wo, Wo, Gg, Gs^Fms, Gs^Fms, Gs^Fms, Hh, Hh, Hh, Rrc, Rrc, Gg, Rrc, Gg, Gg, Gg, Gg, Ww^Bsb|, Ww, Gg, Ww, Gg, Gg
Gg, Gg, Gg, Hh, Hh, Gg, Gg, Gg, Gg, Hh, Gg, Gg, Wo, Wo, Wo, Wo, Wo, Wo, Wo, Wo, Wo, Wo, Wo, Wo, Wo, Wo, Wo, Wo, Wo, Wo, Wo, Gg, Gs^Fms, Gs^Fms, Gs^Fms, Rr^Vhc, Rr^Vhc, Rrc, Hh, Hh, Gg, Gg, Gg, Gg, Ww, Ww, Rrc, Gg, Gg, Gg, Gg, Gg
Gg, Gg, Gg, Hh, Gg, Gg, Gg, Gg, Gg, Gg, Gg, Gg, Wo, Wo, Wo, Wo, Wo, Wo, Wo, Wo, Wo, Wo, Wo, Wo, Wo, Wo, Wo, Wo, Wo, Wo, Wo, Gg, Gg, Gs^Fms, Rrc, Rr^Vhc, Rr^Vhc, Ww, Ww, Hh, Ww, Gg, Ww, Ww, Gg, Gg, Rrc, Gg, Gs^Fms, Gs^Fms, Gs^Fms, Gg
Gg, Gg, Gg, Hh, Gg, Gg, Wo, Gg, Gg, Gg, Gg, Gg, Wo, Wo, Wo, Wo, Wo, Wo, Wo, Wo, Wo, Wo, Wo, Wo, Wo, Wo, Wo, Wo, Wo, Wo, Wo, Rr^Vhc, Rr^Vhc, Rrc, Gs^Fms, Rr^Vhc, Ww^Bsb|, Ww^Bsb\, Rr^Vhc, Ww, Gg, Ww, Gg, Gg, Gg, Gg, Rrc, Gg, Gs^Fms, Gs^Fms, Gs^Fms, Wo
Wo, Gg, Wo, Gg, Wo, Wo, Wo, Wo, Wo, Wo, Wo, Wo, Wo, Wo, Wo, Wo, Wo, Wo, Wo, Wo, Wo, Wo, Wo, Wo, Wo, Wo, Wo, Wo, Gg, Wo, Rr^Vhc, Rr^Vhc, Rr^Vhc, Gg, Gs^Fms, Gs^Fms, Rr^Vhc, Rr^Vhc, Rr^Vhc, Hh, Gg, Gg, Gg, Gg, Hh, Gg, Rrc, Gg, Gg, Gs^Fms, Gg, Wo
Wo, Wo, Wo, Wo, Wo, Wo, Wo, Wo, Wo, Wo, Wo, Wo, Wo, Wo, Wo, Wo, Wo, Wo, Wo, Wo, Wo, Wo, Gg, Wo, Gg, Gg, Hh, Gg, Hh, Hh, Hh, Rr^Vhc, Hh, Rrc, Rrc, Gs^Fms, Gg, Rr^Vhc, Hh, Rrc, Gg, Gs^Fms, Gs^Fms, Hh, Hh, Gg, Rrc, Gg, Gg, Gg, Gg, Wo
Wo, Wo, Wo, Wo, Wo, Wo, Wo, Wo, Wo, Wo, Wo, Wo, Wo, Wo, Wo, Wo, Wo, Wo, Wo, Wo, Wo, Gg, Wo, Gg, Hh, Hh, Hh, Hh, Hh, Hh, Hh, Ww, Ww, Gg, Gg, Rrc, Rrc, Hh, Hh, Rrc, Rrc, Gs^Fms, Gs^Fms, Gs^Fms, Gs^Fms, Gs^Fms, Gs^Fms, Rrc, Hh, Gg, Gg, Wo
Wo, Wo, Wo, Wo, Wo, Wo, Wo, Wo, Wo, Wo, Wo, Wo, Wo, Wo, Wo, Wo, Wo, Wo, Wo, Wo, Wo, Wo, Wo, Gg, Hh, Hh, Hh, Hh, Hh, Hh, Hh, Hh, Hh, Ww, Ww, Gg, Rrc, Hh, Hh, Hh, Gg, Rrc, Gs^Fms, Gs^Fms, Gs^Fms, Gs^Fms, Gg, Rrc, Hh, Gg, Gg, Wo
Wo, Wo, Wo, Wo, Wo, Wo, Wo, Wo, Wo, Wo, Wo, Wo, Wo, Wo, Wo, Wo, Wo, Wo, Wo, Wo, Wo, Wo, Wo, Wo, Hh, Hh, Hh, Hh, Hh, Hh, Hh, Hh, Hh, Gg, Gg, Ww, Gg, Rrc, Gg, Gg, Gg, Rrc, Gg, Gs^Fms, Gs^Fms, Gs^Fms, Gg, Rrc, Gg, Gg, Gg, Wo
Wo, Wo, Wo, Wo, Wo, Wo, Wo, Wo, Wo, Wo, Wo, Wo, Wo, Wo, Wo, Wo, Wo, Wo, Wo, Wo, Wo, Wo, Wo, Wo, Hh, Hh, Hh, Hh, Hh, Hh, Hh, Hh, Hh, Gg, Gg, Ww, Gg, Rrc, Rrc, Gg, Gg, Rrc, Rr^Vhc, Rr^Vhc, Gg, Gg, Gs^Fms, Rrc, Gg, Gg, Gg, Gg
Wo, Wo, Wo, Wo, Wo, Wo, Wo, Wo, Wo, Wo, Wo, Wo, Wo, Wo, Wo, Wo, Wo, Wo, Wo, Wo, Wo, Wo, Gg, Hh, Hh, Hh, Hh, Hh, Hh, Hh, Hh, Hh, Hh, Hh, Gg, Ww, Gg, Gg, Gg, Rrc, Hh, Rr^Vhc, Rr^Vhc, Rr^Vhc, Gg, Gs^Fms, Gg, Rrc, Gg, Gs^Fms, Gs^Fms, Gg
Wo, Wo, Wo, Wo, Wo, Wo, Wo, Wo, Wo, Wo, Wo, Wo, Wo, Wo, Wo, Wo, Wo, Wo, Wo, Wo, Wo, Gg, Hh, Hh, Hh, Hh, Hh, Hh, Hh, Hh, Rr^Vhc, Hh, Hh, Hh, Gg, Ww, Rrc, Gg, Rrc, Rrc, Rrc, Rrc, Rr^Vhc, Rrc, Rrc, Gg, Gg, Rrc, Gg, Gs^Fms, Gg, Gg
Wo, Wo, Wo, Wo, Wo, Wo, Wo, Wo, Wo, Wo, Wo, Wo, Wo, Wo, Wo, Wo, Wo, Wo, Wo, Wo, Wo, Wo, Wo, Gg, Gg, Gg, Gg, Hh, Hh, Rr^Vhc, Rr^Vhc, Rr^Vhc, Hh, Rrc, Rrc, Ww^Bsb/, Rrc, Rrc, Hh, Hh, Rrc, Rrc, Gg, Gg, Rrc, Rrc, Gg, Rrc, Gg, Gg, Gg, Gg
Wo, Wo, Wo, Wo, Wo, Wo, Wo, Wo, Wo, Wo, Wo, Wo, Wo, Wo, Wo, Wo, Wo, Wo, Wo, Wo, Wo, Wo, Wo, Wo, Wo, Gg, Gg, Gg, Gg, Rr^Vhc, Rr^Vhc, Rr^Vhc, Gg, Gg, Gg, Ww, Gs^Fms, Gs^Fms, Gs^Fms, Rrc, Gg, Gg, Gg, Gg, Hh, Rrc, Gg, Rrc, Gg, Gg, Gg, Gg
Wo, Wo, Wo, Wo, Wo, Wo, Wo, Wo, Wo, Wo, Wo, Wo, Wo, Wo, Wo, Wo, Wo, Wo, Wo, Wo, Wo, Wo, Wo, Wo, Wo, Wo, Wo, Wo, Wo, Wo, Wo, Wo, Wo, Gg, Ww, Ww, Gs^Fms, Gg, Rrc, Rrc, Gg, Gs^Fms, Gs^Fms, Gg, Gg, Rrc, Rrc, Rrc, Rr^Vhc, Rr^Vhc, Rr^Vhc, Gg
Wo, Wo, Wo, Wo, Wo, Wo, Wo, Wo, Wo, Wo, Wo, Wo, Wo, Wo, Wo, Wo, Wo, Wo, Wo, Wo, Wo, Wo, Wo, Wo, Wo, Wo, Wo, Wo, Wo, Wo, Wo, Wo, Wo, Ww, Gs^Fms, Gs^Fms, Gs^Fms, Rrc, Rrc, Gg, Gs^Fms, Gs^Fms, Gs^Fms, Gg, Ch, Gg, Ch, Rr^Vhc, Rr^Vhc, Rr^Vhc, Rr^Vhc, Gg
Wo, Wo, Wo, Wo, Wo, Wo, Wo, Wo, Wo, Wo, Wo, Wo, Wo, Wo, Wo, Wo, Wo, Wo, Wo, Wo, Wo, Wo, Wo, Wo, Wo, Wo, Wo, Wo, Wo, Wo, Wo, Wo, Wo, Gg, Gg, Gs^Fms, Rrc, Rrc, Gg, Gg, Gg, Gg, Gg, Gg, Ch, 1 Kh, Ch, Gg, Rr^Vhc, Rr^Vhc, Rr^Vhc, Gg
Wo, Wo, Wo, Wo, Wo, Wo, Wo, Wo, Wo, Wo, Wo, Wo, Wo, Wo, Wo, Wo, Wo, Wo, Wo, Wo, Wo, Wo, Wo, Wo, Wo, Wo, Wo, Wo, Wo, Wo, Gg, Gg, Gg, Gg, Rrc, Rrc, Gg, Gg, Gg, Gg, Gg, Gg, Gg, Gg, Gg, Gg, Gg, Gg, Gg, Gg, Gg, Gg
Wo, Wo, Wo, Wo, Wo, Wo, Wo, Wo, Wo, Wo, Wo, Wo, Wo, Wo, Wo, Wo, Wo, Wo, Wo, Wo, Wo, Wo, Wo, Wo, Wo, Wo, Gg, Gg, Gg, Gg, Gg, Gg, Hh, Gg, Rrc, Rrc, Gg, Gg, Gg, Gg, Gg, Gg, Gg, Gg, Gg, Gg, Gg, Gg, Gg, Gg, Gg, Gg
Wo, Wo, Wo, Wo, Wo, Wo, Wo, Wo, Wo, Wo, Wo, Wo, Wo, Wo, Wo, Wo, Wo, Wo, Wo, Wo, Wo, Wo, Gg, Gg, Gg, Gg, Gg, Hh, Gg, Gg, Rr^Vhc, Rr^Vhc, Rr^Vhc, Hh, Gg, Gg, Gg, Gg, Gg, Gg, Gg, Gg, Gg, Gg, Wo, Gg, Wo, Wo, Wo, Wo, Wo, Gg
Wo, Wo, Wo, Wo, Wo, Wo, Wo, Wo, Wo, Wo, Wo, Wo, Wo, Wo, Wo, Wo, Wo, Wo, Gg, Gg, Gg, Hh, Gg, Gg, Gg, Gg, Gg, Hh, Gg, Gg, Rr^Vhc, Rr^Vhc, Gg, Gg, Gg, Gg, Wo, Wo, Wo, Wo, Wo, Wo, Wo, Wo, Wo, Wo, Wo, Wo, Wo, Wo, Wo, Wo
Wo, Wo, Wo, Wo, Wo, Wo, Wo, Wo, Wo, Wo, Wo, Wo, Wo, Wo, Wo, Wo, Gg, Gg, Gg, Gg, Gg, Hh, Gg, Gg, Gg, Hh, Gg, Gg, Gg, Gg, Wo, Gg, Wo, Wo, Wo, Wo, Wo, Wo, Wo, Wo, Wo, Wo, Wo, Wo, Wo, Wo, Wo, Wo, Wo, Wo, Wo, Wo
Wo, Wo, Wo, Wo, Wo, Wo, Wo, Wo, Wo, Wo, Wo, Wo, Gg, Wo, Gg, Gg, Gg, Gg, Gg, Gg, Wo, Gg, Gg, Gg, Gg, Gg, Wo, Gg, Wo, Wo, Wo, Wo, Wo, Wo, Wo, Wo, Wo, Wo, Wo, Wo, Wo, Wo, Wo, Wo, Wo, Wo, Wo, Wo, Wo, Wo, Wo, Wo
Wo, Wo, Wo, Wo, Wo, Wo, Wo, Wo, Wo, Wo, Wo, Wo, Wo, Gg, Wo, Wo, Wo, Wo, Wo, Wo, Wo, Wo, Wo, Wo, Wo, Wo, Wo, Wo, Wo, Wo, Wo, Wo, Wo, Wo, Wo, Wo, Wo, Wo, Wo, Wo, Wo, Wo, Wo, Wo, Wo, Wo, Wo, Wo, Wo, Wo, Wo, Wo
Wo, Wo, Wo, Wo, Wo, Wo, Wo, Wo, Wo, Wo, Wo, Wo, Wo, Wo, Wo, Wo, Wo, Wo, Wo, Wo, Wo, Wo, Gg, Wo, Gg, Wo, Gg, Wo, Gg, Wo, Gg, Wo, Wo, Wo, Wo, Wo, Wo, Wo, Wo, Wo, Wo, Wo, Wo, Wo, Wo, Wo, Wo, Wo, Wo, Wo, Wo, Wo