Hh, Hh, Hh, Hh, Hh, Hh, Hh, Hh, Hh, Rrc, Hh, Hh, Hh, Hh, Hh, Wot, Wot, Hh, Hh, Rrc, Wot, Wot, Wot, Hh, Wot, Hh, Wot, Hh, Wot, Hh, Rr^Vhc, Hh, Hh, Hh, Hh, Hh, Hh, Gg, Hh, Gg, Hh, Mm, Mm, Mm, Mm, Mm, Mm, Mm, Mm, Mm, Mm, Mm, Mm, Mm, Mm, Mm, Mm, Mm, Mm, Mm, Mm, Mm, Mm, Mm, Mm, Mm, Hh, Hh, Hh, Hh, Hh, Gg, Gg, Gg, Gg, Gg, Gs^Fms, Gg, Gg, Gg, Rr^Vhc, Gg, Gg, Gg, Gg, Gg
Hh, Hh, Hh, Hh, Hh, Hh, Hh, Hh, Hh, Rrc, Hh, Hh, Hh, Hh, Wot, Hh, Wot, Wot, Wot, Wot, Hh, Wot, Hh, Wot, Hh, Wot, Hh, Wot, Hh, Wot, Wot^Bsb|, Wot, Wot, Wot, Wot, Wot, Wot, Hh, Wot, Hh, Hh, Mm, Hh, Mm, Hh, Hh, Hh, Hh, Hh, Hh, Hh, Hh, Hh, Hh, Hh, Hh, Hh, Hh, Hh, Mm, Wot, Wot, Mm, Mm, Mm, Mm, Mm, Hh, Hh, Hh, Hh, Hh, Gg, Gg, Gg, Gs^Fms, Gs^Fms, Gs^Fms, Gs^Fms, Gg, Rr^Vhc, Rr^Vhc, Rr^Vhc, Gg, Gg, Gg
Hh, Hh, Hh, Hh, Hh, Hh, Hh, Hh, Hh, Rrc, Rrc, Hh, Hh, Hh, Wot, Wot, Hh, Hh, Hh, Rrc, Hh, Hh, Hh, Hh, Hh, Hh, Hh, Hh, Hh, Rr^Vhc, Rr^Vhc, Rr^Vhc, Hh, Hh, Hh, Hh, Gg^Qov, Wot, Wot, Wot, Rr^Vhc, Hh, Gg, Hh, Hh, Hh, Gg, Hh, Hh, Hh, Gg, Hh, Gg, Hh, Gg, Gg, Wot, Wot, Wot, Wot, Hh, Mm, Mm, Mm, Mm, Mm, Mm, Mm, Mm, Hh, Hh, Hh, Hh, Hh, Hh, Gg, Gs^Fms, Gs^Fms, Gs^Fms, Gg, Gg, Rr^Vhc, Ch, 1 Kh, Ch, Gg
Hh, Hh, Hh, Hh, Hh, Hh, Hh, Hh, Hh, Hh, Hh, Rrc, Wot^Bsb\, Wot, Hh, Hh, Hh, Hh, Rr^Vhc, Rrc, Rr^Vhc, Hh, Rrc, Hh, Rrc, Hh, Rrc, Hh, Rrc, Rr^Vhc, Rrc, Rr^Vhc, Rrc, Hh, Rrc, Rrc, Rrc, Rr^Vhc, Rr^Vhc, Wot, Wot^Bsb/, Rr^Vhc, Gg, Gg, Gs^Fms, Gg, Gg, Gg, Gg, Gg, Gg, Gg, Wot, Wot, Wot, Wot, Gg, Gg, Gg, Hh, Gg, Hh, Hh, Mm, Mm, Mm, Mm, Mm, Mm, Mm, Mm, Hh, Hh, Hh, Hh, Gg, Gg, Gs^Fms, Gs^Fms, Gg, Gg, Rrc, Ch, Ch, Ch, Gg
Hh, Hh, Hh, Hh, Hh, Hh, Hh, Hh, Hh, Hh, Hh, Hh, Wot, Rrc, Rrc, Hh, Hh, Rr^Vhc, Rr^Vhc, Rr^Vhc, Rr^Vhc, Rrc, Hh, Rrc, Hh, Rrc, Hh, Rrc, Hh, Rrc, Hh, Rrc, Hh, Rrc, Gg, Gg, Gg, Rr^Vhc, Rr^Vhc, Rr^Vhc, Rr^Vhc, Wot, Gg, Gs^Fms, Gs^Fms, Gs^Fms, Gs^Fms, Gs^Fms, Gs^Fms, Gg, Gg, Gg, Wot, Wot, Gs^Fms, Gg, Gs^Fms, Gs^Fms, Gs^Fms, Gg, Gg, Gg, Gg, Hh, Hh, Mm, Mm, Mm, Mm, Mm, Mm, Hh, Hh, Hh, Hh, Hh, Gg, Gg, Gg, Gg, Gg, Rrc, Gg, Ch, Gs^Fms, Gs^Fms
Rrc, Rrc, Rrc, Rrc, Rrc, Rrc, Rrc, Rrc, Rrc, Rrc, Wot^Bsb\, Wot, Hh, Hh, Hh, Rrc, Rrc, Rr^Vhc, Rr^Vhc, Rr^Vhc, Rr^Vhc, Rr^Vhc, Hh, Hh, Hh, Hh, Hh, Hh, Hh, Hh, Hh, Hh, Hh, Gg, Gs, Gs, Gs, Gg, Rr^Vhc, Rr^Vhc, Gg, Wot, Gg, Gs^Fms, Gg, Gs^Fms, Gs^Fms, Gs^Fms, Gs^Fms, Gg, Gg, Wot, Gg, Gs^Fms, Gs^Fms, Gs^Fms, Gs^Fms, Gs^Fms, Gs^Fms, Gs^Fms, Gg, Gs^Fms, Gg, Gg, Hh, Hh, Mm, Mm, Mm, Mm, Mm, Mm, Hh, Hh, Hh, Hh, Hh, Gg, Gg, Gg, Gg, Rrc, Gg, Gs^Fms, Gs^Fms, Gg
Hh, Hh, Hh, Hh, Hh, Hh, Hh, Hh, Hh, Hh, Wot, Wot^Bsb\, Rrc, Hh, Hh, Hh, Rrc, Rrc, Rr^Vhc, Rr^Vhc, Rr^Vhc, Hh, Hh, Hh, Hh, Hh, Hh, Hh, Hh, Hh, Hh, Hh, Gg, Gg, Gs, Gs, Gs^Fms, Gg, Gg, Rrc, Gg, Wot, Gg, Gg, Gd, Gg, Gs^Fms, Gs^Fms, Gs^Fms, Gs^Fms, Wot, Wot, Gs^Fms, Gs^Fms, Gs^Fms, Gs^Fms, Gs^Fms, Gs^Fms, Gg, Gs^Fms, Gg, Gs^Fms, Gg, Hh, Hh, Hh, Hh, Mm, Mm, Mm, Mm, Mm, Mm, Hh, Hh, Hh, Hh, Hh, Hh, Gg, Gg, Rrc, Gg, Gg, Gg, Gg
Hh, Hh, Hh, Hh, Hh, Hh, Hh, Wot, Wot, Wot, Hh, Hh, Hh, Rrc, Rrc, Rrc, Hh, Hh, Hh, Hh, Hh, Hh, Hh, Hh, Mm, Hh, Mm, Mm, Mm, Hh, Hh, Hh, Hh, Gg, Gs, Gs, Gs^Fms, Gg, Gg, Rrc, Wot, Wot, Gd, Gd, Gd, Gd, Gg, Gs^Fms, Gg, Gg, Wot, Wot, Gg, Gg, Gs^Fms, Gg, Gg, Gg, Gs^Vh, Gg, Gg, Gg, Gg, Hh, Hh, Hh, Hh, Mm, Mm, Mm, Mm, Mm, Mm, Hh, Hh, Hh, Hh, Hh, Hh, Hh, Gg, Rrc, Rrc, Gg, Gg, Gg
Hh, Hh, Hh, Hh, Hh, Hh, Hh, Hh, Hh, Hh, Hh, Hh, Hh, Hh, Xu, Rrc, Xu, Hh, Mm, Hh, Hh, Hh, Mm, Mm, Mm, Mm, Mm, Mm, Mm, Mm, Hh, Hh, Hh, Gg, Gg, Gs, Gg, Gg, Gg, Rrc, Wot, Gd, Gd, Gd, Gd, Gd, Gg, Gs^Fms, Gg, Gg, Wot, Gg, Gg, Gs^Fms, Rrc, Rrc, Rrc, Rrc, Gs^Fms, Rrc, Rrc, Gg, Hh, Hh, Hh, Hh, Hh, Mm, Mm, Mm, Mm, Mm, Mm, Hh, Hh, Hh, Hh, Hh, Hh, Hh, Gg, Gg, Rrc, Gg, Gg, Gg
Hh, Hh, Mm, Hh, Mm, Hh, Mm, Mm, Mm, Mm, Mm, Mm, Mm, Mm, Xu, Rrc, Xu, Mm, Mm, Mm, Mm, Mm, Mm, Mm, Mm, Mm, Mm, Mm, Mm, Mm, Mm, Mm, Hh, Hh, Gg, Gs, Gg, Rr^Vhc, Rr^Vhc, Rrc, Wot^Bsb\, Gd, Rrc, Rrc, Rrc, Rrc, Rrc, Rrc, Rrc, Wot^Bsb\, Rrc, Rrc, Rrc, Rrc, Gg, Gg, Gg, Gs^Fms, Gs^Fms, Gg, Hh, Rrc, Rrc, Hh, Hh, Hh, Hh, Hh, Mm, Mm, Mm, Mm, Mm, Hh, Hh, Hh, Hh, Hh, Hh, Hh, Gg, Gg, Rrc, Gg, Gg, Gg
Mm, Mm, Mm, Mm, Mm, Mm, Mm, Mm, Mm, Mm, Mm, Mm, Mm, Mm, Xu, Rrc, Xu, Mm, Mm, Mm, Mm, Mm, Mm, Mm, Mm, Mm, Mm, Mm, Mm, Mm, Mm, Mm, Hh, Hh, Hh, Gg, Gg, Rr^Vhc, Rr^Vhc, Rr^Vhc, Wot, Rr^Vhc, Rr^Vhc, Rrc, Ch, Ch, Gs^Fms, Gs^Fms, Gg, Wot, Gg, Gg, Gs^Fms, Gg, Gs^Fms, Gs^Fms, Gg, Gg, Hh, Gg, Hh, Hh, Hh, Rrc, Rrc, Hh, Wot, Wot, Wot, Mm, Wot, Mm, Mm, Mm, Hh, Hh, Hh, Hh, Hh, Hh, Gg, Gg, Rrc, Gg, Gg, Gg
Hh^Qov, Mm, Ms, Mm, Ms, Ms, Ms, Ms, Ms, Ms, Ms, Mm, Ms, Ms, Xu, Rrc, Xu, Ms, Ms, Mm, Mm, Mm, Mm, Mm, Mm, Mm, Mm, Mm, Mm, Mm, Wot, Mm, Hh, Hh, Hh, Gg, Rrc, Rr^Vhc, Rr^Vhc, Rr^Vhc, Wot^Bsb\, Rr^Vhc, Rr^Vhc, Ch, Gd, 7 Kh, Gs^Fms, Gs^Fms, Wot, Wot, Gg, Gg, Gs^Fms, Gs^Fms, Gs^Fms, Gs^Fms, Hh, Hh, Hh, Hh, Hh, Hh, Hh, Hh, Hh, Wot^Bsb\, Rrc, Hh, Hh, Wot, Mm, Mm, Mm, Mm, Hh, Hh, Hh, Hh, Hh, Hh, Gg, Gg, Rrc, Gg, Gg, Gg
Ms, Ms, Ms, Ms, Ms, Ms, Mm, Ms, Ms, Mm, Mm, Ms, Ms, Ms, Xu, Rrc, Xu, Ms, Ms, Ms, Ms, Mm, Mm, Mm, Mm, Mm, Mm, Mm, Mm, Mm, Hh, Wot, Wot, Hh, Rrc, Rrc, Gs^Fms, Gs^Fms, Gg, Rr^Vhc, Wot, Rr^Vhc, Gd, Rrc, Rrc, Gg, Gs^Fms, Gg, Wot, Wot, Wot, Gg, Wot, Gg, Hh, Hh, Hh, Hh, Hh, Hh, Hh, Hh, Hh, Hh, Hh, Wot, Rrc, Hh, Hh, Mm, Mm, Mm, Mm, Mm, Mm, Hh, Hh, Hh, Hh, Hh, Gs^Fms, Gg, Rrc, Gg, Gg, Gg
Ms, Ms, Ms, Ms, Ms, Mm, Mm, Mm, Mm, Mm, Mm, Mm, Mm, Ms, Xu, Rrc, Xu, Mm, Mm, Ms, Ms, Mm, Mm, Mm, Mm, Mm, Mm, Mm, Mm, Mm, Mm, Hh, Rrc, Wot^Bsb/, Wot, Gg, Gs^Fms, Gs^Fms, Gs^Fms, Wot, Wot, Gd, Gd, Gd, Gg, Rrc, Rrc, Gg, Wot, Gg, Gg, Wot, Gg, Wot, Wot, Wot, Wot, Hh, Wot, Hh, Wot, Hh, Wot, Hh, Wot, Wot, Rrc, Hh, Hh, Mm, Mm, Mm, Mm, Mm, Mm, Hh, Hh, Hh, Hh, Gg, Gs^Fms, Gs^Fms, Rrc, Gg, Gg, Gg
Ms, Ms, Ms, Ms, Mm, Mm, Wot, Wot, Mm, Mm, Mm, Mm, Mm, Mm, Xu, Rrc, Xu, Mm, Mm, Mm, Mm, Mm, Mm, Mm, Mm, Mm, Mm, Mm, Mm, Mm, Rrc, Rrc, Rp, Hh, Hh, Wot, Gs^Fms, Gs^Fms, Gs^Fms, Wot, Gg, Gs^Fms, Gs^Fms, Gd, Gg, Gg, Gg, Rrc, Wot^Bsb\, Gg, Gs^Fms, Gg, Gg, Hh, Hh, Hh, Hh, Wot, Hh, Wot, Hh, Wot, Hh, Wot, Hh, Hh, Rrc, Hh, Hh, Mm, Mm, Mm, Mm, Mm, Mm, Hh, Hh, Hh, Gg, Gg, Gs^Fms, Gg, Gg, Rrc, Gg, Gg
Mm, Ms, Mm, Mm, Mm, Mm, Mm, Wot, Wot, Mm, Mm, Mm, Mm, Mm, Xu, Rrc, Xu, Mm, Mm, Mm, Mm, Mm, Mm, Mm, Mm, Mm, Hh, Mm, Rrc, Rrc, Mm, Mm, Hh, Rp, Gg, Wot, Gg, Gs^Fms, Gg, Wot, Gg, Gs^Fms, Gs^Fms, Gs^Fms, Gg, Gg, Gg, Wot, Gg, Rrc, Gs^Fms, Gs^Fms, Gg, Hh, Hh, Hh, Hh, Hh, Hh, Hh, Mm, Hh, Mm, Mm, Mm, Hh, Rrc, Hh, Mm, Mm, Mm, Mm, Mm, Mm, Mm, Gg, Gg, Hh, Gg, Gs^Fms, Gs^Fms, Gg, Rr^Vhc, Rr^Vhc, Wo, Wo
Mm, Mm, Mm, Mm, Mm, Mm, Wot, Wot, Mm, Mm, Mm, Mm, Mm, Mm, Xu, Rrc, Xu, Mm, Hh, Mm, Hh, Mm, Hh, Hh, Hh, Mm, Rrc, Rrc, Mm, Mm, Hh, Hh, Hh, Rp, Gg, Wot, Wot, Gg, Gg, Wot, Gg, Gs^Fms, Gs^Fms, Gs^Fms, Gs^Fms, Gg, Gg, Wot, Gg, Rrc, Gs^Fms, Gs^Fms, Gg, Hh, Mm, Hh, Mm, Mm, Mm, Mm, Mm, Mm, Mm, Mm, Mm, Mm, Rrc, Mm, Mm, Mm, Mm, Mm, Mm, Mm, Mm, Gg, Gg, Gg, Gg, Gs^Fms, Gg, Gg, Rrc, Rr^Vhc, Wo, Wo
Mm, Hh, Mm, Mm, Mm, Mm, Wot, Wot, Rr^Vhc, Hh, Gg, Hh, Gg, Hh, Hh, Rrc, Hh, Hh, Gg, Hh, Gg, Hh, Gg, Gg, Rrc, Rrc, Mm, Mm, Mm, Hh, Hh, Hh, Hh, Rp, Gg, Gs^Fms, Gs^Fms, Wot, Wot, Wot, Gg, Gs^Fms, Gs^Fms, Gs^Fms, Gs^Fms, Gg, Wot, Wot, Gs^Fms, Rrc, Gs^Fms, Gs^Fms, Gg, Mm, Mm, Mm, Mm, Mm, Mm, Mm, Mm, Mm, Mm, Mm, Mm, Mm, Rrc, Mm, Mm, Mm, Mm, Mm, Mm, Mm, Hh, Gg, Wot, Gg, Wot, Gg, Wot^Bsb|, Rrc, Gg, Wo, Wo, Wo
Hh, Mm, Mm, Mm, Gg, Wot, Wot, Rr^Vhc, Rr^Vhc, Rr^Vhc, Rrc, Rrc, Rrc, Rrc, Rrc, Rrc, Gd, Gd, Rrc, Gg, Rr^Vhc, Gg, Rrc, Rrc, Rr^Vhc, Hh, Hh, Mm, Mm, Hh, Hh, Hh, Gg, Rp, Rp, Gs^Fms, Gs^Fms, Gs^Fms, Gs^Fms, Wot, Wot, Gg, Gg, Gs^Fms, Gg, Gg, Wot, Gs^Fms, Gs^Fms, Rrc, Gs^Fms, Gs^Fms, Hh, Hh, Mm, Mm, Mm, Mm, Mm, Mm, Mm, Mm, Mm, Mm, Mm, Mm, Rrc, Mm, Mm, Mm, Mm, Mm, Mm, Mm, Gg, Wot, Gg, Wot, Gg, Wot, Rrc, Wot, Wo, Wo, Wo, Wo
Wot, Wot, Wot, Wot, Wot^Bsb|, Wot, Gg, Wot^Bsb/, Wot, Rr^Vhc, Wot, Gg, Wot, Gg, Wot, Rr^Vhc, Rr^Vhc, Rr^Vhc, Wo, Rrc, Wo, Rr^Vhc, Rrc, Hh, Rr^Vhc, Hh, Hh, Mm, Mm, Hh, Hh, Hh, Gg, Rp, Rp, Gg, Gs^Fms, Gs^Fms, Gs^Fms, Gg, Gg, Wot, Wot, Gg, Gg, Gg, Wot, Gs^Fms, Gs^Fms, Rrc, Gg, Gs^Fms, Hh, Hh, Hh, Hh, Hh, Mm, Hh, Mm, Hh, Mm, Hh, Mm, Hh, Mm, Rrc, Mm, Mm, Mm, Hh, Mm, Hh, Hh, Gg, Wot, Gg, Gg, Rrc, Rrc, Gg, Gg, Wo, Wo, Wo, Wo
Hh, Mm, Wot, Wot, 2 Kh, Gs^Fms, Gs^Fms, Gg, Gg, Wot, Gs^Fms, Wot, Gg, Wot, Rr^Vhc, Wot^Bsb/, Wot, Wo, Wo, Wo, Wo, Wo, Rrc, Hh, Hh, Hh, Hh, Mm, Rr^Vhc, Hh, Hh, Hh, Hh, Gg, Rp, Rp, Rp, Gs^Fms, Gs^Fms, Gs^Fms, Gs^Fms, Wot, Wot, Wot, Wot, Gg, Wot, Gs^Fms, Gg, Rrc, Rrc, Gg, Rrc, Hh, Rrc, Hh, Rrc, Hh, Hh, Hh, Hh, Hh, Hh, Hh, Hh, Rr^Vhc, Rr^Vhc, Rr^Vhc, Rr^Vhc, Mm, Rrc, Hh, Rrc, Gg, Rrc, Wot, Rrc, Rrc, Gg, Gg, Gg, Gg, Wo, Wo, Wo, Wo
Wot, Wot, Gg, Ch, Ch, Ch, Gs^Fms, Gs^Fms, Gg, Gs^Fms, Gs^Fms, Gs^Fms, Gg, Gd, Rr^Vhc, Rr^Vhc, Wo, Wo, Wo, Wo, Wo, Wo, Hh, Rrc, Rrc, Hh, Hh, Rr^Vhc, Rr^Vhc, Mm, Hh, Hh, Mm, Hh, Rp, Hh, Hh, Rp, Rp, Gs^Fms, Gs^Fms, Gs^Fms, Gg, Wot, Gg, Wot, Wot, Wot, Wot^Bsb/, Rrc, Wot, Rrc, Gg, Rrc, Gg, Rrc, Gg, Rrc, Rrc, Rrc, Rrc, Rrc, Rrc, Rrc, Rrc, Rr^Vhc, Rr^Vhc, Rr^Vhc, Rr^Vhc, Rrc, Gg, Rrc, Gg, Rrc, Wot, Wot, Rrc, Gg, Gs^Fms, Gs^Fms, Gs^Fms, Wo, Wo, Wo, Wo, Wo
Hh, Hh, Hh, Gg, Hh, Hh, Mm, Hh, Hh, Gg, Gg, Gg, Rrc, Rrc, Wo, Wo, Wo, Wo, Wo, Wo, Wo, Wo, Hh, Wo, Wo, Rrc, Rrc, Rr^Vhc, Hh, Mm, Hh, Mm, Mm, Hh, Rp, Hh, Mm, Hh, Hh, Rp, Rp, Gs^Fms, Gs^Fms, Gs^Fms, Gg, Gg, Gg, Rr^Vhc, Rr^Vhc, Wot, Wot, Wot^Bsb|, Wot, Wot, Wot, Gg, Wot, Gg, Gs^Fms, Gs^Fms, Gs^Fms, Gs^Fms, Gs^Fms, Gg, Rrc, Rr^Vhc, Ch, Rr^Vhc, Gg, Gg, Gg, Gg, Gg, Gg, Wot, Gg, Rrc, Gg, Gs^Fms, Gs^Fms, Gg, Wo, Wo, Wo, Wo, Wo
Hh, Hh, Hh, Hh, Wo, Hh, Hh, Mm, Mm, Hh, Rrc, Rrc, Gg, Rrc, Wo, Wo, Wo, Wo, Wo, Wo, Wo, Wo, Gg, Wo, Wo, Wo, Wo, Rrc, Mm, Hh, Hh, Hh, Hh, Rr^Vhc, Rr^Vhc, Hh, Mm, Hh, Hh, Hh, Hh, Rp, Rp, Gg, Hh, Gg, Hh, Rr^Vhc, Rr^Vhc, Wot, Wot^Bsb/, Rrc, Rrc, Wot, Gg, Wot, Gg, Wot, Wot, Gg, Wot, Gg, Rrc, Rrc, Gg, Ch, 6 Kh, Ch, Wot, Gg, Wot, Gg, Wot, Wot, Gg, Rrc, Gg, Gs^Fms, Gs^Fms, Gs^Fms, Gg, Wo, Wo, Wo, Wo, Wo
Hh, Hh, Wo, Wo, Wo, Wo, Hh, Hh, Mm, Rrc, Mm, Hhd, Hhd, Rrc, Wo, Wo, Wo, Wo, Wo, Wo, Wo, Wo, Wo, Wo, Wo, Wo, Wo, Rrc, Mm, Hh, Hh, Hh, Hh, Rr^Vhc, Rr^Vhc, Rr^Vhc, Mm, Mm, Mm, Hh, Hh, Hh, Hh, Rp, Rp, Hh, Rp, Rr^Vhc, Rr^Vhc, Wot^Bsb/, Wot, Hh, Hh, Rrc, Rrc, Gg, Gg, Gg, Gg, Wot, Gg, Wot, Wot, Wot, Wot, Wot, Wot, Wot, Gg, Wot, Gg, Wot, Gg, Gg, Gg, Rrc, Gg, Gs^Fms, Gs^Fms, Gg, Gg, Wo, Wo, Wo, Wo, Wo
Wo, Wo, Wo, Wo, Wo, Wo, Wo, Hh, Rrc, Rrc, Mm, Mm, Mm, Rrc, Wo, Wo, Wo, Wo, Wo, Wo, Wo, Wo, Wo, Wo, Wo, Wo, Wo, Rrc, Rrc, Hh, Hh, Hh, Hh, Mm, Hh, Mm, Rr, Mm, Hh, Mm, Hh, Hh, Rp, Hh, Rp, Rp, Hh, Hh, Hh, Hh, Wot, Hh, Hh, Hh, Hh, Rrc, Rrc, Gs^Fms, Gs^Fms, Gs^Fms, Gg, Rrc, Gg, Gg, Gg, Gg, Gs^Fms, Gg, Gs^Fms, Gg, Gs^Fms, Gs^Fms, Gs^Fms, Gg, Gg, Rrc, Gs^Fms, Gs^Fms, Gg, Gg, Wo, Wo, Wo, Wo, Wo, Wo
Wo, Wo, Wo, Wo, Wo, Wo, Wo, Wo, Wo, Rrc, Hhd, Mm, Mm, Rrc, Rrc, Wo, Wo, Wo, Wo, Wo, Wo, Wo, Wo, Wo, Wo, Wo, Wo, Wo, Rrc, Hh, Md, Md, Hh, Mm, Hh, Rr, Mm, Mm, Mm, Mm, Rr^Vhc, Hh, Rp, Rp, Ch, Mm, Mm, Hh, Hh, Hh, Wot, Mm, Mm, Hh, Hh, Hh, Hh, Rrc, Rrc, Gs^Fms, Gg, Rrc, Gg, Gs^Fms, Gs^Fms, Gs^Fms, Gg, Gs^Fms, Gg, Gs^Fms, Gg, Gs^Fms, Gg, Gs^Fms, Gg, Rrc, Gs^Fms, Gs^Fms, Wo, Wo, Wo, Wo, Wo, Wo, Wo, Wo
Wo, Wo, Wo, Wo, Wo, Wo, Wo, Wo, Wo, Rrc, Hhd, Mm, Mm, Hhd, Rr^Vhc, Wo, Wo, Wo, Wo, Wo, Wo, Wo, Wo, Wo, Wo, Wo, Wo, Wo, Wo, Rrc, Rrc, Md, Mm, Mm, Mm, Rr, Rr, Hh, Mm, Mm, Rr^Vhc, Rr^Vhc, Mm, Ch, 5 Kh, Ch, Hh, Mm, Mm, Hh, Hh, Wot, Hh, Hh, Hh, Mm, Mm, Hh, Rrc, Gg, Rrc, Rrc, Hh, Gg, Hh, Gg, Hh, Gg, Hh, Hh, Hh, Hh, Gg, Gg, Rrc, Rrc, Gs^Fms, Gs^Fms, Wo, Wo, Wo, Wo, Wo, Wo, Wo, Wo
Wo, Wo, Wo, Wo, Wo, Wo, Wo, Wo, Wo, Rrc, Rrc, Hhd, Hhd, Rr^Vhc, Rr^Vhc, Wo, Wo, Wo, Wo, Wo, Wo, Wo, Wo, Wo, Wo, Wo, Wo, Wo, Wo, Wo, Md, Rrc, Rrc, Mm, Mm, Hh, Hh, Rr, Rr, Rp, Mm, Hh, Mm, Mm, Mm, Ch, Hh, Hh, Hh, Hh, Hh, Wot, Hh, Hh, Mm, Hh, Hh, Hh, Rr^Vhc, Rrc, Rrc, Hh, Hh, Hh, Hh, Hh, Hh, Hh, Mm, Hh, Hh, Gg, Gs^Fms, Gg, Rrc, Gg, Gg, Gg, Wo, Wo, Wo, Wo, Wo, Wo, Wo, Wo
Wo, Wo, Wo, Wo, Wo, Wo, Wo, Wo, Wo, Wo, Rrc, Hhd, Hhd, Hhd, Hhd, Rrc, Wo, Wo, Wo, Wo, Wo, Wo, Wo, Wo, Wo, Wo, Wo, Wo, Wo, Wo, Wo, Md, Md, Rrc, Mm, Mm, Mm, Hh, Rr, Mm, Mm, Mm, Mm, Hh, Hh, Hh, Mm, Hh, Hh, Hh, Hh, Wot, Hh, Mm, Mm, Hh, Hh, Hh, Rr^Vhc, Rr^Vhc, Hh, Hh, Mm, Mm, Hh, Hh, Hh, Mm, Mm, Hh, Hh, Gg, Gs^Fms, Gg, Rrc, Gg, Gg, Gg, Wo, Wo, Wo, Wo, Wo, Wo, Wo, Wo
Wo, Wo, Wo, Wo, Wo, Wo, Wo, Wo, Wo, Wo, Rrc, Hhd, Hhd, Hhd, Md, Rrc, Rrc, Wo, Wo, Wo, Wo, Wo, Wo, Wo, Wo, Wo, Wo, Wo, Wo, Wo, Wo, Wo, Wo, Rrc, Rrc, Mm, Mm, Mm, Hh, Rr, Rr, Rr, Rr, Rr, Rr, Rr, Rr, Rr^Vhc, Rr^Vhc, Mm, Hh, Wot, Hh, Mm, Hh, Hh, Hh, Rr^Vhc, Rr^Vhc, Rr^Vhc, Hh, Hh, Hh, Hh, Mm, Hh, Hh, Hh, Hh, Hh, Hh, Gg, Gg, Rrc, Gg, Gg, Wo, Wo, Wo, Wo, Wo, Wo, Wo, Wo, Wo, Wo
Wo, Wo, Wo, Wo, Wo, Wo, Wo, Wo, Wo, Wo, Wo, Rrc, Hhd, Hhd, Md, Md, Hhd, Rrc, Rrc, Wo, Wo, Wo, Wo, Wo, Wo, Wo, Wo, Wo, Wo, Wo, Wo, Wo, Wo, Wo, Rrc, Mm, Mm, Mm, Mm, Hh, Hh, Rr, Mm, Hh, Hh, Rr, Hh, Rr^Vhc, Rr, Mm, Hh, Wot, Hh, Mm, Hh, Hh, Hh, Rr^Vhc, Mm, Rr^Vhc, Rrc, Hh, Hh, Mm, Mm, Mm, Mm, Hh, Hh, Hh, Gs^Fms, Gg, Gg, Rrc, Gg, Wo, Wo, Wo, Wo, Wo, Wo, Wo, Wo, Wo, Wo, Wo
Wo, Wo, Wo, Wo, Wo, Wo, Wo, Wo, Wo, Wo, Wo, Rrc, Rrc, Gg^Ve, Rr^Vhc, Wot, Md, Hhd, Hhd, Rrc, Wo, Wo, Wo, Wo, Wo, Wo, Wo, Wo, Wo, Wo, Wo, Wo, Wo, Wo, Wo, Rrc, Rrc, Mm, Mm, Mm, Rr^Vhc, Rr^Vhc, Hh, Mm, Mm, Mm, Mm, Hh, Hh, Rr, Hh, Hh, Hh, Mm, Hh, Hh, Rr, Rr, Hh, Hh, Hh, Rrc, Rrc, Mm, Hh, Mm, Hh, Hh, Gs^Fms, Gs^Fms, Gs^Fms, Gg, Rrc, Rrc, Wo, Wo, Wo, Wo, Wo, Wo, Wo, Wo, Wo, Wo, Wo, Wo
Wo, Wo, Wo, Wo, Wo, Wo, Wo, Wo, Wo, Wo, Wo, Wo, Rrc, Rr^Vhc, Wot, Wot, Md, Md, Md, Rrc, Rrc, Wo, Wo, Wo, Wo, Wo, Wo, Wo, Wo, Wo, Wo, Wo, Wo, Wo, Wo, Wo, Wo, Rrc, Rrc, Rrc, Rrc, Rr^Vhc, Hh, Hh, Hh, Mm, Mm, Mm, Mm, Rr, Hh, Mm, Hh, Mm, Rr, Rr, Hh, Mm, Mm, Hh, Hh, Hh, Gg, Rrc, Rrc, Gg, Gs^Fms, Gs^Fms, Gs^Fms, Gs^Fms, Gs^Fms, Gg, Rrc, Rrc, Wo, Wo, Wo, Wo, Wo, Wo, Wo, Wo, Wo, Wo, Wo, Wo
Wo, Wo, Wo, Wo, Wo, Wo, Wo, Wo, Wo, Wo, Wo, Wo, Wo, Rr^Vhc, Wot^Bsb\, Rr^Vhc, Rr^Vhc, Md, Md, Hhd, Hhd, Rrc, Rrc, Wo, Wo, Wo, Wo, Wo, Wo, Wo, Wo, Wo, Wo, Wo, Wo, Wo, Wo, Wo, Hhd, Mm, Mm, Mm, Hh, Hh, Hh, Hh, Hh, Hh, Hh, Rr^Vhc, Mm, Hh, Rr, Rr, Hh, Hh, Hh, Hh, Hh, Hh, Wot, Hh, Wot, Gg, Gs^Fms, Rrc, Rrc, Gs^Fms, Gs^Fms, Gs^Fms, Gs^Fms, Gs^Fms, Rrc, Gg, Wo, Wo, Wo, Wo, Wo, Wo, Wo, Wo, Wo, Wo, Wo, Wo
Wo, Wo, Wo, Wo, Wo, Wo, Wo, Wo, Wo, Wo, Wo, Wo, Wo, Wo, Wo, Rr^Vhc, Rrc, Hhd, Hhd, Md, Md, Hhd, Hhd, Rrc, Wo, Wo, Wo, Wo, Wo, Wo, Wo, Wo, Wo, Wo, Wo, Wo, Wo, Wo, Wo, Mm, Mm, Hh, Hh, Hh, Hh, Hh, Hh, Hh, Mm, Rr, Rr, Rr, Hh, Hh, Mm, Hh, Hh, Hh, Hh, Hh, Hh, Wot, Wot, Wot, Wot, Gs^Fms, Gs^Fms, Rrc, Rrc, Gs^Fms, Gs^Fms, Gs^Fms, Rrc, Gg, Wo, Wo, Wo, Wo, Wo, Wo, Wo, Wo, Wo, Wo, Wo, Wo
Wo, Wo, Wo, Wo, Wo, Wo, Wo, Wo, Wo, Wo, Wo, Wo, Wo, Wo, Wo, Wo, Wo, Rrc, Hhd, Md, Md, Hhd, Hhd, Rrc, Rrc, Wo, Gd^Fts, Wo, Wo, Wo, Wo, Wo, Wo, Wo, Wo, Wo, Wo, Wo, Wo, Mm, Mm, Hh, Hh, Mm, Hh, Hh, Mm, Wot, Wot, Mm, Rr, Mm, Hh, Mm, Mm, Mm, Mm, Hh, Hh, Hh, Hh, Mm, Hh, Hh, Hh, Wot, Wot, Gs^Fms, Gs^Fms, Rrc, Rrc, Gg, Rrc, Gg, Wo, Wo, Wo, Wo, Wo, Wo, Wo, Wo, Wo, Wo, Wo, Wo
Wo, Wo, Wo, Wo, Wo, Wo, Wo, Wo, Wo, Wo, Wo, Wo, Wo, Wo, Wo, Wo, Wo, Rrc, Rrc, Hhd, Rr^Vhc, Md, Md, Hhd, Gd, Rrc, Gd^Fts, Gd^Fts, Wo, Wo, Wo, Wo, Wo, Wo, Wo, Wo, Wo, Wo, Wo, Hh, Mm, Mm, Hh, Mm, Mm, Hh, Mm, Mm, Mm, Wot, Hh, Rr, Rr, Hh, Mm, Mm^Xm, Mm, Mm, Mm, Hh, Hh, Mm, Mm, Hh, Hh, Hh, Hh, Wot, Gg, Gg, Gg, Rrc, Gs^Fms, Gs^Fms, Gs^Fms, Wo, Wo, Wo, Wo, Wo, Wo, Wo, Wo, Wo, Wo, Wo
Wo, Wo, Wo, Wo, Wo, Wo, Wo, Wo, Wo, Wo, Wo, Wo, Wo, Wo, Wo, Wo, Wo, Wo, Wo, Rrc, Rr^Vhc, Rr^Vhc, Md, Md, Hhd, Rrc, Rrc, Wo, Wo, Wo, Wo, Wo, Wo, Wo, Wo, Wo, Wo, Wo, Gd, Md, Mm, Mm, Mm, Mm, Mm, Hh, Mm, Mm, Mm, Wot, Wot, Hh, Rr, Hh, Mm, Mm, Mm, Mm, Mm, Hh, Hh, Hh, Hh, Hh, Hh, Hh, Hh, Wot, Wot, Gg, Gs^Fms, Rrc, Rrc, Gs^Fms, Gs^Fms, Wo, Wo, Wo, Wo, Wo, Wo, Wo, Wo, Wo, Wo, Wo
Wo, Wo, Wo, Wo, Wo, Wo, Wo, Wo, Wo, Wo, Wo, Wo, Wo, Wo, Wo, Wo, Wo, Wo, Wo, Wo, Wo, Rr^Vhc, Rrc, Md, Hhd, Hhd, Rrc, Wo, Wo, Wo, Wo, Wo, Wo, Wo, Wo, Wo, Wo, Wo, Wo, Md, Md, Mm, Mm, Hh, Mm, Hh, Hh, Mm, Hh, Mm, Hh, Wot, Rr, Mm, Mm, Mm, Mm, Mm, Hh, Hh, Hh, Hh, Hh, Hh, Hh, Hh, Hh, Hh, Wot, Gs^Fms, Gs^Fms, Gs^Fms, Rrc, Gs^Fms, Gg, Gg, Wo, Wo, Wo, Wo, Wo, Wo, Wo, Wo, Wo, Wo
Wo, Wo, Wo, Wo, Wo, Wo, Wo, Wo, Wo, Wo, Wo, Wo, Wo, Wo, Wo, Wo, Wo, Wo, Wo, Wo, Wo, Wo, Rrc, Hhd, Hhd, Hhd, Hhd, Rrc, Rrc, Wo, Wo, Wo, Wo, Wo, Wo, Wo, Wo, Wo, Wo, Md, Md, Mm, Mm, Hh, Mm, Hh, Hh, Mm, Mm, Mm, Hh, Wot, Wot, Rr, Hh, Mm, Hh, Hh, Rrc, Rrc, Rrc, Rrc, Rrc, Rrc, Rrc, Rrc, Rrc, Rrc, Wot^Bsb\, Rrc, Rrc, Rrc, Gg, Rrc, Gg, Gg, Rr^Vhc, Wo, Wo, Wo, Wo, Wo, Wo, Wo, Wo, Wo
Wo, Wo, Wo, Wo, Wo, Wo, Wo, Wo, Wo, Wo, Wo, Wo, Wo, Wo, Wo, Wo, Wo, Wo, Wo, Wo, Wo, Wo, Wo, Rrc, Hhd, Hhd, Rrc, Rrc, Wo, Hhd, Hhd, Wo, Wo, Wo, Wo, Wo, Wo, Wo, Wo, Wo, Md, Mm, Mm, Hh, Hh, Hh, Hh, Mm, Mm, Mm, Hh, Hh, Wot^Bsb/, Rr, Rr, Hh, Rrc, Rrc, Hhd, Hhd, Gd, Hhd, Wo, Gd, Wo, Gd, Gd, Gg, Wot, Gg, Rr, Gg, Gg, Rrc, Rr^Vhc, Rr^Vhc, Rr^Vhc, Wo, Wo, Wo, Wo, Wo, Wo, Wo, Wo, Wo
Wo, Wo, Wo, Wo, Wo, Wo, Wo, Wo, Wo, Wo, Wo, Wo, Wo, Wo, Wo, Wo, Wo, Wo, Wo, Wo, Wo, Wo, Wo, Rrc, Rrc, Rrc, Hhd, Gd^Fts, Wo, Wo, Wo, Hhd, Wo, Wo, Wo, Wo, Wo, Wo, Wo, Wo, Md, Mm, Rr^Vhc, Hh, Hh, Hh, Hh, Mm, Hh, Hh, Hh, Rrc, Wot, Gg, Wo, Rr^Vhc, Rr^Vhc, Hhd, Wo, Wo, Wo, Wo, Wo, Wo, Wo, Wo, Wo, Wo, Wo, Gg, Rr, Gg, Wo, Wo, Wo, Wo, Rr^Vhc, Rr^Vhc, Rr^Vhc, Wo, Wo, Wo, Wo, Wo, Wo, Wo
Wo, Wo, Wo, Wo, Wo, Wo, Wo, Wo, Wo, Wo, Wo, Wo, Wo, Wo, Wo, Wo, Wo, Wo, Wo, Wo, Wo, Wo, Wo, Wo, Wo, Rrc, Hhd, Wo, Wo, Wo, Wo, Wo, Wo, Wo, Wo, Wo, Wo, Wo, Wo, Wo, Wo, Md, Rr^Vhc, Rr^Vhc, Mm, Hh, Mm, Hh, Hh, Hh, Hh, Rrc, Wo, Wo, Wo, Rr^Vhc, Gd, Gd, Wo, Wo, Wo, Wo, Wo, Wo, Wo, Wo, Wo, Wo, Wo, Wo, Rr, Wo, Wo, Wo, Wo, Wo, Wo, Wo, Wo, Wo^Bsb\, Rr^Vhc, Rr^Vhc, Wot, Gg, Hh, Hh
Wo, Wo, Wo, Wo, Wo, Wo, Wo, Wo, Wo, Wo, Wo, Wo, Wo, Wo, Wo, Wo, Wo, Wo, Wo, Wo, Wo, Wo, Wo, Wo, Wo, Rrc, Hhd, Wo, Wo, Wo, Wo, Wo, Wo, Wo, Wo, Wo, Wo, Wo, Wo, Wo, Wo, Md, Md, Mm, Mm, Hh, Mm, Mm, Hh, Hh, Rrc, Rrc, Wo, Wo, Wo, Wo, Wo, Wo, Wo, Wo, Wo, Wo, Wo, Wo, Wo, Wo, Wo, Wo, Wo, Gg, Wo, Wo^Bsb\, Gd, Wo, Gd, Wo, Wo, Wo, Rrc, Rr^Vhc, Rr^Vhc, Rr^Vhc, Wot, Gg, Hh, Hh
Wo, Wo, Wo, Wo, Wo, Wo, Wo, Wo, Wo, Wo, Wo, Wo, Wo, Wo, Wo, Wo, Wo, Wo, Wo, Wo, Wo, Wo, Wo, Wo, Rrc, Rrc, Hhd, Hhd, Wo, Wo, Wo, Wo, Wo, Wo, Wo, Wo, Wo, Wo, Wo, Wo, Wo, Wo, Md, Md, Hh, Hh, Mm, Mm, Mm, Rrc, Hh, Hh, Wo, Wo, Wo, Wo, Wo, Wo, Wo, Wo, Wo, Wo, Wo, Wo, Wo, Wo, Wo, Wo, Wo, Wo, Gd, Rr, Rr, Gd, Rrc, Rrc, Rrc, Rrc, Hhd, Hhd, Hh, Hh, Wot, Gg, Hh, Hh
Wo, Wo, Wo, Wo, Wo, Wo, Wo, Wo, Wo, Wo, Wo, Wo, Wo, Wo, Wo, Wo, Wo, Wo, Wo, Wo, Gd^Fts, Wo, Wo, Wo, Rrc, Hhd, Wo, Wo, Wo, Wo, Wo, Wo, Wo, Wo, Wo, Wo, Wo, Wo, Wo, Wo, Wo, Wo, Md, Md, Hh, Hh, Hh, Mm, Hh, Rrc, Hh, Gg, Wo, Wo, Wo, Wo, Wo, Wo, Wo, Wo, Wo, Wo, Wo, Wo, Wo, Wo, Wo, Wo, Wo, Wo, Hhd, Gd, Rrc, Rrc, Gd, Gd, Ch, Ch, Hhd, Md, Md, Hh, Gg, Wot, Hh, Hh
Wo, Wo, Wo, Wo, Wo, Wo, Wo, Wo, Wo, Wo, Wo, Wo, Wo, Wo, Wo, Wo, Wo, Wo, Wo, Wo, Hh^Vhh, Gd, Wo^Bsb\, Rrc, Wo, Wo, Wo, Wo, Wo, Wo, Wo, Wo, Wo, Wo, Wo, Wo, Wo, Wo, Wo, Wo, Wo, Wo, Hh, Hhd, Rrc, Rrc, Rrc, Hh, Hh, Rrc, Hhd, Hhd, Wo, Wo, Wo, Wo, Wo, Wo, Wo, Wo, Wo, Wo, Wo, Wo, Wo, Wo, Wo, Wo, Wo, Wo, Rrc, Rrc, Hhd, Hhd, Hhd, Gd, Ch, Ch, Hhd, Md, Md, Hh, Hh, Wot, Wot, Hh
Wo, Wo, Wo, Wo, Wo, Wo, Wo, Wo, Wo, Wo, Wo, Wo, Wo, Gd^Fts, Gd^Fts, Rr^Vhc, Hhd, Md, Md, Mv, Md, Wo, Wo, Wo, Wo, Wo, Wo, Wo, Wo, Wo, Wo, Wo, Wo, Wo, Wo, Wo, Wo, Wo, Wo, Wo, Wo, Wo, Wo, Hhd, Rrc, Hh, Mm, Rrc, Rrc, Rrc, Hhd, Gd, Wo, Wo, Wo, Wo, Wo, Wo, Wo, Wo, Wo, Wo, Wo, Wo, Wo, Wo, Wo, Wo, Wo, Wo, Rrc, Hhd, Hhd, Hhd, Hhd, Hhd, Ch, 4 Kh, Hhd, Md, Md, Hh, Hh, Hh, Wot, Wot
Wo, Wo, Wo, Wo, Wo, Wo, Wo, Wo, Wo, Wo, Wo, Wo, Wo, Wo, Wo, Gd^Fts, Gd^Fts, Hhd, Hhd, Md, Hhd, Wo, Wo, Wo, Wo, Wo, Wo, Wo, Wo, Wo, Wo, Wo, Wo, Wo, Wo, Wo, Wo, Wo, Wo, Wo, Wo, Wo, Wo, Hhd, Rrc, Mm, Mm, Mm, Mm, Rrc, Rrc, Wo, Wo, Wo, Wo, Wo, Wo, Wo, Wo, Wo, Wo, Hhd, Wo, Wo, Wo, Wo, Wo, Wo, Wo, Hhd, Rrc, Hhd, Md, Md, Md, Hhd, Hhd, Hhd, Hhd, Hhd, Hhd, Hhd, Hh, Hh, Hhd, Wot
Wo, Wo, Wo, Wo, Wo, Wo, Wo, Wo, Wo, Wo, Wo, Wo, Wo, Wo, Wo, Wo, Wo, Wo, Wo, Hhd, Gd^Fts, Gd^Fts, Wo, Wo, Wo, Wo, Wo, Wo, Wo, Wo, Wo, Wo, Wo, Wo, Wo, Wo, Wo, Wo, Wo, Wo, Wo, Wo, Wo, Hhd, Hhd, Rrc, Rrc, Rrc, Rrc, Mm, Rr^Vhc, Gd^Fts, Wo, Hhd, Hhd, Wo, Wo, Wo, Wo, Hhd, Wo, Wo, Wo, Wo, Wo, Wo, Wo, Wo, Wo, Hhd, Rrc, Hhd, Md, Md, Md, Md, Hhd, Hhd, Hhd, Hhd, Hhd, Hhd, Hhd, Hhd, Hhd, Hhd
Wo, Wo, Wo, Wo, Wo, Wo, Wo, Wo, Wo, Wo, Wo, Wo, Wo, Wo, Wo, Wo, Wo, Wo, Wo, Wo, Wo, Gd^Fts, Wo, Wo, Wo, Wo, Wo, Wo, Wo, Wo, Wo, Wo, Wo, Wo, Wo, Wo, Wo, Wo, Wo, Wo, Wo, Wo, Wo, Wo, Wo, Wo, Wo, Wo, Wo, Rrc, Rr^Vhc, Rr^Vhc, Hhd, Wo, Wo, Hhd, Wo, Hhd, Wo, Wo, Hhd, Wo, Wo, Wo, Wo, Wo, Wo, Wo, Wo, Hhd, Rrc, Hhd, Hhd, Md, Hhd, Hhd, Hhd, Hhd, Hhd, Hhd, Hhd, Hhd, Hhd, Hhd, Hhd, Hhd
Wo, Wo, Wo, Wo, Wo, Wo, Wo, Wo, Wo, Wo, Wo, Wo, Wo, Wo, Wo, Wo, Wo, Wo, Wo, Wo, Wo, Wo, Wo, Wo, Wo, Wo, Wo, Wo, Wo, Wo, Wo, Wo, Wo, Wo, Wo, Wo, Wo, Wo, Wo, Wo, Wo, Wo, Wo, Wo, Rr^Vhc, Md, Md, Wo, Wo^Bsb/, Wo^Bsb/, Wo, Rr^Vhc, Gd^Fts, Gd^Fts, Wo, Wo, Wo, Wo, Wo, Wo, Wo, Wo, Wo, Wo, Wo, Wo, Wo, Wo, Wo, Hhd, Rrc, Hhd, Hhd, Hhd, Hhd, Hhd, Hhd, Hhd, Hhd, Hhd, Hhd, Hhd, Hhd, Hhd, Hhd, Hhd
Wo, Wo, Wo, Wo, Wo, Wo, Wo, Wo, Wo, Wo, Wo, Wo, Wo, Wo, Wo, Wo, Wo, Wo, Wo, Wo, Wo, Wo, Wo, Wo, Wo, Wo, Wo, Wo, Wo, Wo, Wo, Wo, Wo, Wo, Wo, Wo, Wo, Wo, Wo, Wo, Wo, Wo, Wo, Rr^Vhc, Rr^Vhc, Md, Ch, Hhd, Hhd, Wo, Wo, Wo, Wo, Wo, Wo, Hhd, Hhd, Wo, Wo, Wo, Hhd, Wo, Wo, Wo, Wo, Wo, Wo, Wo, Wo, Gd, Rrc, Hhd, Gd, Hhd, Hhd, Hhd, Hhd, Hhd, Md, Md, Md, Hhd, Hhd, Hhd, Hhd, Hhd
Wo, Wo, Wo, Wo, Wo, Wo, Wo, Wo, Wo, Wo, Wo, Wo, Wo, Wo, Wo, Wo, Wo, Wo, Wo, Wo, Wo, Wo, Wo, Wo, Wo, Wo, Wo, Wo, Wo, Wo, Wo, Wo, Wo, Wo, Wo, Wo, Wo, Wo, Wo, Wo, Wo, Wo, Wo, Hhd, Wo, Ch, 3 Kh, Wo, Wo, Wo, Wo, Wo, Wo, Wo, Wo, Wo, Wo, Wo, Wo, Wo, Wo, Wo, Hhd, Wo, Wo, Wo, Wo, Wo, Wo, Wo, Gd, Rrc, Gd, Gd, Gd, Gd, Hhd, Hhd, Md, Md, Md, Md, Hhd, Hhd, Hhd, Hhd
Wo, Wo, Wo, Wo, Wo, Wo, Wo, Wo, Wo, Wo, Wo, Wo, Wo, Wo, Wo, Wo, Wo, Wo, Wo, Wo, Wo, Wo, Wo, Wo, Wo, Wo, Wo, Wo, Wo, Wo, Wo, Wo, Wo, Wo, Wo, Wo, Wo, Wo, Wo, Wo, Wo, Wo, Wo, Hhd, Wo, Ch, Wo, Hhd, Wo, Wo, Wo, Wo, Wo, Wo, Wo, Wo, Wo, Wo, Hhd, Wo, Wo, Wo, Wo, Wo, Wo, Wo, Wo, Wo, Wo, Wo, Gd, Rrc, Hhd, Gd, Hhd, Gd, Hhd, Hhd, Md, Md, Md, Md, Hhd, Hhd, Hhd, Hhd
Wo, Wo, Wo, Wo, Wo, Wo, Wo, Wo, Wo, Wo, Wo, Wo, Wo, Wo, Wo, Wo, Wo, Wo, Wo, Wo, Wo, Wo, Wo, Wo, Wo, Wo, Wo, Wo, Wo, Wo, Wo, Wo, Wo, Wo, Wo, Wo, Wo, Wo, Wo, Wo, Wo, Wo, Wo, Hhd, Wo, Hhd, Wo, Wo, Wo, Wo, Wo, Wo, Wo, Wo, Wo, Hhd, Wo, Wo, Wo, Wo, Wo, Wo, Wo, Wo, Wo, Wo, Wo, Wo, Wo, Wo, Wo, Rrc, Hhd, Hhd, Hhd, Hhd, Hhd, Hhd, Hhd, Md, Md, Md, Hhd, Hhd, Hhd, Hhd
Wo, Wo, Wo, Wo, Wo, Wo, Wo, Wo, Wo, Wo, Wo, Wo, Wo, Wo, Wo, Wo, Wo, Wo, Wo, Wo, Wo, Wo, Wo, Wo, Wo, Wo, Wo, Wo, Wo, Wo, Wo, Wo, Wo, Wo, Wo, Wo, Wo, Wo, Wo, Wo, Wo, Wo, Wo, Wo, Wo, Wo, Wo, Wo, Wo, Wo, Wo, Wo, Wo, Wo, Hhd, Wo, Wo, Wo, Wo, Wo, Wo, Hhd, Wo, Wo, Hhd, Wo, Hhd, Wo, Wo, Wo, Wo, Rrc, Rr^Vhc, Rr^Vhc, Rr^Vhc, Hhd, Hhd, Hhd, Wot, Wot, Wot, Wot, Wot, Hhd, Hhd, Hhd
Wo, Wo, Wo, Wo, Wo, Wo, Wo, Wo, Wo, Wo, Wo, Wo, Wo, Wo, Wo, Wo, Wo, Wo, Wo, Wo, Wo, Wo, Wo, Wo, Wo, Wo, Wo, Wo, Wo, Wo, Wo, Wo, Wo, Wo, Wo, Wo, Wo, Wo, Wo, Wo, Wo, Wo, Wo, Wo, Wo, Wo, Wo, Wo, Wo, Wo, Wo, Wo, Wo, Wo, Wo, Wo, Wo, Hhd, Wo, Wo, Wo, Wo, Wo, Wo, Wo, Wo, Wo, Wo, Wo, Wo, Wo, Rr^Vhc, Rr^Vhc, Rr^Vhc, Wot, Wot, Wot, Wot, Hhd, Hhd, Hhd, Hhd, Hhd, Hhd, Md, Hhd
Wo, Wo, Wo, Wo, Wo, Wo, Wo, Wo, Wo, Wo, Wo, Wo, Wo, Wo, Gd, Wo, Wo, Wo, Wo, Wo, Wo, Wo, Wo, Wo, Wo, Wo, Wo, Wo, Wo, Wo, Wo, Wo, Wo, Wo, Wo, Wo, Wo, Wo, Wo, Wo, Wo, Wo, Wo, Wo, Wo, Wo, Wo, Wo, Wo, Wo, Wo, Wo, Wo, Hhd, Wo, Wo, Hhd, Wo, Wo, Hhd, Wo, Wo, Hhd, Wo, Wo, Wo, Wo, Wo, Hhd, Wo, Wo, Wo, Wot, Wot^Bsb\, Rr^Vhc, Hhd, Md, Md, Hhd, Hhd, Hhd, Hhd, Md, Md, Md, Hhd
Wo, Wo, Wo, Wo, Wo, Wo, Wo, Wo, Wo, Wo, Wo, Wo, Wo, Wo, Wo, Wo, Wo, Wo, Wo, Wo, Wo, Wo, Wo, Wo, Wo, Wo, Wo, Wo, Wo, Wo, Wo, Wo, Wo, Wo, Wo, Wo, Wo, Wo, Wo, Wo, Wo, Wo, Wo, Wo, Wo, Wo, Wo, Wo, Wo, Wo, Wo, Wo, Wo, Wo, Wo, Wo, Wo, Wo, Wo, Wo, Wo, Wo, Wo, Wo, Wo, Wo, Wo, Wo, Wo, Wo, Wo, Wo, Wo, Rr^Vhc, Hhd, Hhd, Md, Md, Hhd, Hhd, Hhd, Hhd, Md, Md, Md, Md
Wo, Wo, Wo, Wo, Wo, Wo, Wo, Wo, Wo, Wo, Wo, Wo, Wo, Wo, Wo, Wo, Wo, Wo, Wo, Wo, Wo, Wo, Wo, Wo, Wo, Wo, Wo, Wo, Wo, Wo, Wo, Wo, Wo, Wo, Wo, Wo, Wo, Wo, Wo, Wo, Wo, Wo, Wo, Wo, Wo, Wo, Wo, Wo, Wo, Wo, Wo, Wo, Wo, Wo, Wo, Hhd, Wo, Wo, Wo, Wo, Hhd, Wo, Wo, Wo, Hhd, Hhd, Wo, Wo, Wo, Wo, Wo, Wo, Wo, Gd, Hhd, Hhd, Hhd, Hhd, Hhd, Hhd, Hhd, Hhd, Md, Md, Md, Md
Wo, Wo, Wo, Wo, Wo, Wo, Wo, Wo, Wo, Wo, Wo, Wo, Wo, Wo, Wo, Wo, Wo, Wo, Wo, Wo, Wo, Wo, Wo, Wo, Wo, Wo, Wo, Wo, Wo, Wo, Wo, Wo, Wo, Wo, Wo, Wo, Wo, Wo, Wo, Wo, Wo, Wo, Wo, Wo, Wo, Wo, Wo, Wo, Wo, Wo, Wo, Wo, Wo, Wo, Wo, Wo, Wo, Hhd, Wo, Wo, Wo, Wo, Wo, Wo, Wo, Wo, Hhd, Wo, Hhd, Wo, Wo, Wo, Wo, Wo, Gd, Hhd, Hhd, Hhd, Hhd, Hhd, Hhd, Hhd, Hhd, Md, Hhd, Rr^Vhc
Wo, Wo, Wo, Wo, Wo, Wo, Wo, Wo, Wo, Wo, Wo, Wo, Wo, Wo, Wo, Wo, Wo, Wo, Wo, Wo, Wo, Wo, Wo, Wo, Wo, Wo, Wo, Wo, Wo, Wo, Wo, Wo, Wo, Wo, Wo, Wo, Wo, Wo, Wo, Wo, Wo, Wo, Wo, Wo, Wo, Wo, Wo, Wo, Wo, Wo, Wo, Wo, Wo, Wo, Wo, Wo, Wo, Wo, Wo, Wo, Wo, Wo, Wo, Wo, Wo, Wo, Wo, Wo, Wo, Wo, Wo, Wo, Wo, Wo, Wo, Gd, Gd, Hhd, Hhd, Hhd, Hhd, Hhd, Hhd, Hhd, Gd, Rr^Vhc
Wo, Wo, Wo, Wo, Wo, Wo, Wo, Wo, Wo, Wo, Wo, Wo, Wo, Wo, Wo, Wo, Wo, Wo, Wo, Wo, Wo, Wo, Wo, Wo, Wo, Wo, Wo, Wo, Wo, Wo, Wo, Wo, Wo, Wo, Wo, Wo, Wo, Wo, Wo, Wo, Wo, Wo, Wo, Wo, Wo, Wo, Wo, Wo, Wo, Wo, Wo, Wo, Wo, Wo, Wo, Wo, Wo, Wo, Wo, Wo, Wo, Wo, Wo, Wo, Hhd, Wo, Wo, Wo, Wo, Wo, Wo, Wo, Hhd, Hhd, Wo, Wo, Wo, Gd, Hhd, Hhd, Hhd, Hhd, Hhd, Hhd, Wo, Wo
Wo, Wo, Wo, Wo, Wo, Wo, Wo, Wo, Wo, Wo, Wo, Wo, Wo, Wo, Wo, Wo, Wo, Wo, Wo, Wo, Wo, Wo, Wo, Wo, Wo, Wo, Wo, Wo, Wo, Wo, Wo, Wo, Wo, Wo, Wo, Wo, Wo, Wo, Wo, Wo, Wo, Wo, Wo, Wo, Wo, Wo, Wo, Wo, Wo, Wo, Wo, Wo, Wo, Wo, Wo, Wo, Wo, Wo, Wo, Wo, Wo, Wo, Wo, Wo, Wo, Wo, Hhd, Wo, Wo, Wo, Wo, Wo, Hhd, Hhd, Wo, Wo, Wo, Wo, Wo, Gd, Gd, Hhd, Hhd, Wo, Wo, Wo
Wo, Wo, Wo, Wo, Wo, Wo, Wo, Wo, Wo, Wo, Wo, Wo, Wo, Wo, Wo, Wo, Wo, Wo, Wo, Wo, Wo, Wo, Wo, Wo, Wo, Wo, Wo, Wo, Wo, Wo, Wo, Wo, Wo, Wo, Wo, Wo, Wo, Wo, Wo, Wo, Wo, Wo, Wo, Wo, Wo, Wo, Wo, Wo, Wo, Wo, Wo, Wo, Wo, Wo, Wo, Wo, Wo, Wo, Wo, Wo, Wo, Wo, Wo, Wo, Wo, Wo, Wo, Wo, Wo, Wo, Wo, Wo, Wo, Wo, Wo, Wo, Wo, Wo, Wo, Wo, Wo, Wo, Wo, Wo, Wo, Wo
Wo, Wo, Wo, Wo, Wo, Wo, Wo, Wo, Wo, Wo, Wo, Wo, Wo, Wo, Wo, Wo, Wo, Wo, Wo, Wo, Wo, Wo, Wo, Wo, Wo, Wo, Wo, Wo, Wo, Wo, Wo, Wo, Wo, Wo, Wo, Wo, Wo, Wo, Wo, Wo, Wo, Wo, Wo, Wo, Wo, Wo, Wo, Wo, Wo, Wo, Wo, Wo, Wo, Wo, Wo, Wo, Wo, Wo, Wo, Wo, Wo, Wo, Wo, Wo, Wo, Wo, Wo, Wo, Wo, Wo, Wo, Wo, Wo, Wo, Wo, Wo, Wo, Wo, Wo, Wo, Wo, Wo, Wo, Wo, Wo, Wo
Wo, Wo, Wo, Wo, Wo, Wo, Wo, Wo, Wo, Wo, Wo, Wo, Wo, Wo, Wo, Wo, Wo, Wo, Wo, Wo, Wo, Wo, Wo, Wo, Wo, Wo, Wo, Wo, Wo, Wo, Wo, Wo, Wo, Wo, Wo, Wo, Wo, Wo, Wo, Wo, Wo, Wo, Wo, Wo, Wo, Wo, Wo, Wo, Wo, Wo, Wo, Wo, Hhd, Hhd, Md, Wo, Md, Wo, Hhd, Wo, Md, Wo, Wo, Wo, Wo, Wo, Wo, Wo, Wo, Wo, Wo, Wo, Wo, Wo, Wo, Wo, Wo, Wo, Wo, Wo, Wo, Wo, Wo, Wo, Wo, Wo
Wo, Wo, Wo, Wo, Wo, Wo, Wo, Wo, Wo, Wo, Wo, Wo, Wo, Wo, Wo, Wo, Wo, Wo, Wo, Wo, Wo, Wo, Wo, Wo, Wo, Wo, Wo, Wo, Wo, Wo, Wo, Wo, Wo, Wo, Wo, Wo, Wo, Wo, Wo, Wo, Wo, Wo, Wo, Wo, Wo, Wo, Wo, Wo, Wo, Wo, Wo, Wo, Gg, Md, Gg, Md, Wo, Md, Gg, Md, Gg, Wo, Gg, Wo, Gg, Wo, Wo, Wo, Wo, Wo, Wo, Wo, Wo, Wo, Wo, Wo, Wo, Wo, Wo, Wo, Wo, Wo, Wo, Wo, Wo, Wo