Gg, Gg, Gg, Gg, Gg, Gg, Gg, Gg, Gg, Gg, Gg, Rrc, Rrc, Gg, Gg, Gg, Wwg, Gg, Gg, Gg, Gg, Gg, Gg, Gg, Gg, Gs^Fms, Gs^Fms, Gs^Fms, Rrc, Gg, Gg, Gg, Gs^Fms, Gs^Fms, Gs^Fms, Gs^Fms, Gs^Fms, Gg, Gg, Gg, Gg, Gg, Gg, Gs^Fms, Gs^Fms, Gs^Fms, Gs^Fms, Gs^Fms, Gs^Fms, Gs^Fms, Gs^Fms, Gs^Fms, Gs^Fms, Gg, Gg, Gg, Wot, Gg, Gg, Gg, Gg, Gg, Gg, Gg, Gg, Gg, Gg, Gg, Rr, Gg, Gg, Gg, Gg, Gg, Gg, Gg, Gg, Gg, Gg, Gg, Gg, Gg
Gg, Gg, Gg, Gg, Gg, Gg, Gg, Gg, Gg, Gg, Gg, Rrc, Gg, Gg, Gg, Gg, Wwg, Gg, Gg, Gg, Gg, Gg, Gll^Fp, Gg, Gg, Gs^Fms, Gs^Fms, Gs^Fms, Rrc, Gg, Gg, Gg, Gs^Fms, Gs^Fms, Gs^Fms, Gs^Fms, Gs^Fms, Gs^Fms, Gg, Gg, Gg, Gg, Gg, Gs^Fms, Gs^Fms, Gs^Fms, Gs^Fms, Gs^Fms, Gs^Fms, Gs^Fms, Gs^Fms, Gs^Fms, Gs^Fms, Gg, Gg, Gg, Wot, Gg, Wot, Gg, Gg, Gg, Gg, Gg, Gg, Gg, Wot, Wot, Gg, Rr, Rr, Gg, Wot, Gg, Gg, Gg, Gs^Fds, Gg, Gg, Gg, Gg, Gg
Gg, Gg, Gg, Gg, Gg, Gg, Gg, Gg, Gg, Gg, Gg, Rrc, Gg, Gg, Gg, Gg, Wwg, Gg, Gg, Gg, Gg, Gll^Fp, Gll^Fp, Gll^Fp, Gs^Fms, Gs^Fms, Gs^Fms, Gs^Fms, Rrc, Gg, Gg, Gg, Gs^Fms, Gs^Fms, Gs^Fms, Gs^Fms, Gs^Fms, Gs^Fms, Gs^Fms, Gg, Gg, Gg, Gg, Gg, Gg, Gs^Fms, Gg, Gs^Fms, Gs^Fms, Gs^Fms, Gs^Fms, Gs^Fms, Gs^Fms, Gg, Gg, Gg, Gg, Wot, Gg, Wot, Gg, Gg, Gg, Gg, Gg, Gg, Gg, Wot, Gll^Fp, Gll^Fp, Gg, Rr, Gg, Wot, Gg, Gs^Fds, Gs^Fds, Gs^Fds, Gll^Fp, Gg, Gg, Gg
Gg, Gg, Gg, Gg, Gg, Gg, Gg, Gg, Gs^Vh, Gg, Gg, Rrc, Gg, Gg, Wwg, Wwg, Gg, Gg, Gg, Gg, Gg, Gll^Fp, Gs^Fds, Gs^Fds, Gs^Fds, Gs^Fms, Gs^Fms, Gs^Fms, Rrc, Gg, Gs^Fms, Gs^Fms, Gs^Fms, Gs^Fms, Gs^Fms, Gs^Fms, Gs^Fms, Gs^Fms, Gs^Fms, Gs^Fms, Gll^Fp, Gg, Wot, Gg, Gg, Gg, Gg, Wot, Gs^Fms, Gs^Fms, Gs^Fms, Gs^Fms, Gs^Fms, Gg, Gg, Gg, Gg, Gg, Gg, Gg, Gg, Gg, Gg, Gg, Gg, Gg, Gg, Gll^Fp, Gs^Fds, Gs^Fds, Gs^Fds, Rr, Rr, Gg, Gg, Gs^Fds, Gs^Fds, Gs^Fds, Gll^Fp, Gll^Fp, Gg, Gg
Gg, Gg, Gg, Gg, Gg, Gg, Gg, Gg, Gg, Gg, Gg, Rrc, Gg, Gg, Wwg, Gg, Gg, Gg, Gg, Gg, Gg, Gll^Fp, Gs^Fds, Gs^Fds, Gs^Fds, Gs^Fms, Gs^Fms, Gs^Fms, Rrc, Gg, Gs^Fms, Gs^Fms, Gs^Fms, Gs^Fms, Gs^Fms, Gs^Fms, Gs^Fms, Gs^Fms, Gs^Fds, Wot, Gs^Fds, Gll^Fp, Gg, Gg, Gg, Gg, Gg, Wot, Gs^Fms, Gs^Fms, Gs^Fms, Gs^Fms, Gg, Gg, Gg, Gg, Gg, Gg, Gg, Gg, Gg, Gg, Gg, Gg, Gg, Gg, Gg, Gll^Fp, Gs^Fds, Gs^Fds, Gs^Fds, Gg, Rr, Gg, Gg, Gg, Gg, Gll^Fp, Gll^Fp, Gll^Fp, Gg, Gg
Gg, Gg, Gg, Gg, Gg, Gg, Gg, Gg, Gg, Gg, Gg, Rrc, Gg, Gg, Wwg, Gg, Gg, Gg, Gg, Gg, Gs^Fds, Gs^Fds, Gs^Fds, Gs^Fds, Gs^Fds, Gs^Fms, Gs^Fms, Gs^Fms, Rrc, Rrc, Gg, Gs^Fms, Gg, Gs^Fms, Gs^Fms, Gs^Fms, Gs^Fms, Gs^Fms, Gs^Fds, Gs^Fds, Gs^Fds, Gs^Fds, Gg, Gg, Gg, Gg, Gs^Fms, Wot, Gs^Fms, Gs^Fms, Gs^Fms, Gs^Fms, Gg, Gg, Gg, Gg, Gg, Gg, Rb^Gvs, Rb^Gvs, Rb^Gvs, Gg, Gg, Gg, Rrc, Gg, Rrc, Gll^Fp, Rrc, Gs^Fds, Rrc, Gg, Rr^Vhc, Gg, Gs^Fms, Gg, Gg, Gg, Gg, Gg, Gg, Gg
Gg, Gg, Gg, Gg, Gg, Gg, Gg, Gg, Gg, Gg, Gg, Rrc, Rrc, Gg, Wwg, Gg, Gg, Gg, Gg, Gg, Gs^Fds, Gs^Fds, Gs^Fds, Gs^Fds, Gll^Fp, Gll^Fp, Gg, Gg, Gg, Rrc, Gg, Gg, Gg, Gg, Gg, Gs^Fms, Gg, Gg, Wot, Gs^Fds, Gs^Fds, Gs^Fds, Gs^Fds, Gg, Gs^Fms, Gs^Fms, Gs^Fms, Gs^Fms, Gs^Fms, Gs^Fms, Gs^Fms, Gs^Fms, Gg, Gg, Gg, Gg, Rb^Gvs, Rb^Gvs, Rb^Gvs, Rb^Gvs, Rrc, Rrc, Rrc, Rrc, Gg, Rrc, Gg, Rrc, Gg, Rrc, Gg, Rr^Vhc, Rr^Vhc, Rr^Vhc, Rr, Rr, Rr, Rr, Rr, Rr, Rr, Gg
Gg, Gg, Gg, Gg, Gg, Gg, Gg, Gg, Gg, Gg, Gg, Gg, Rr^Vhc, Rrc, Wwg^Bsb\, Gg, Gg, Gg, Gg, Gg, Gg, Gs^Fds, Gg, Gg, Gg, Gll^Fp, Gg, Gg, Gg, Rrc, Gg, Gg, Gg, Gg, Gg, Gg, Gg, Gg, Gg, Gs^Fds, Gs^Fds, Gs^Fds, Gs^Fds, Gg, Gs^Fms, Gs^Fms, Gs^Fms, Gs^Fms, Gs^Fms, Gs^Fms, Gg, Gg, Gg, Gg, Gg, Rb^Gvs, Rrc, Rrc, Rrc, Rrc, Rb^Gvs, Rb^Gvs, Gg, Gg, Gg, Gg, Gg, Gg, Gg, Gg, Gg, Rr^Vhc, Rr^Vhc, Rr^Vhc, Gg, Gs^Fms, Gg, Gg, Gg, Gg, Gg, Gg
Gg, Gg, Gg, Gg, Gg, Gg, Gg, Gg, Gg, Gg, Gg, Rr^Vhc, Rr^Vhc, Rr^Vhc, Wwg, Rrc, Rrc, Rrc, Rrc, Rrc, Rrc, Gg, Rrc, Gg, Rrc, Gg, Gg, Gg, Gg, Rrc, Rrc, Gg, Gg, Gg, Gg, Gg, Gg, Gg, Gg, Gll^Fp, Gs^Fds, Gs^Fds, Gs^Fds, Gg, Gg, Gs^Fms, Gs^Fms, Gs^Fms, Gg, Gg, Gg, Gg, Gg, Gg, Rrc, Rrc, Rb^Gvs, Rb^Gvs, Rb^Gvs, Rb^Gvs, Rb^Gvs, Rb^Gvs, Wwg, Gg, Wwg, Gg, Wwg, Wwg, Wwg, Wwg, Wwg, Wwg, Wwg, Rr^Vhc, Wwg, Gg, Wwg, Gg, Wwg, Gg, Wwg, Gg
Gg, Gg, Gg, Gg, Gg, Gg, Wwg, Gg, Wwg, Wwg, Wwg, Wwg, Wwg^Bsb|, Wwg, Wwg, Gg, Rrc, Gg, Rb^Gvs, Rb^Gvs, Rb^Gvs, Rrc, Rb^Gvs, Rrc, Rrc, Rrc, Rrc, Gg, Gg, Gg, Rrc, Gg, Gg, Gg, Gg, Gg, Gs^Vh, Gg, Gg, Gll^Fp, Gll^Fp, Gs^Fds, Gg, Gg, Gg, Gg, Gg, Gg, Gg, Gg, Gg, Gg, Rrc, Rrc, Rb^Gvs, Rb^Gvs, Rb^Gvs, Rb^Gvs, Wwg, Rb^Gvs, Wwg, Wwg, Wwg, Wwg, Gg, Wwg, Gll^Fp, Gg, Gg, Gg, Gg, Gg, Gs^Fms, Wwg^Bsb|, Gs^Fms, Wwg, Gs^Fms, Wwg, Gg, Wwg, Gg, Gg
Rrc, Gg, Wwg, Wwg, Wwg, Wwg, Rrc, Wwg, Rrc, Rrc, Rrc, Rr^Vhc, Rr^Vhc, Rr^Vhc, Rr^Vhc, Wwg, Rrc, Gg, Gg, Rb^Gvs, Rb^Gvs, Rb^Gvs, Rb^Gvs, Rb^Gvs, Rb^Gvs, Gg, Gg, Rrc, Rrc, Rrc, Rrc, Rrc, Gg, Gg, Gg, Gg, Gg, Gg, Gg, Gg, Gg, Gg, Rb^Gvs, Gg, Gg, Gg, Gg, Gg, Gg, Gg, Rrc, Rrc, Gg, Rb^Gvs, Rb^Gvs, Rb^Gvs, Wwg, Wwg, Wwg, Wwg, Gg, Gg, Gg, Gg, Gg, Gll^Fp, Gll^Fp, Gll^Fp, Gg, Gg, Gg, Gs^Fms, Gs^Fms, Rrc, Gs^Fms, Gs^Fms, Gs^Fms, Gs^Fms, Gg, Gg, Gg, Gg
Wwg, Wwg^Bsb\, Rrc, Rrc, Rrc, Rrc, Rb^Gvs, Rrc, Rb^Gvs, Gs^Fms, Gs^Fms, Gs^Fms, Gs^Fms, Rr^Vhc, Rrc, Wwg^Bsb/, Wwg, Gg, Gg, Gg, Gg, Rb^Gvs, Rb^Gvs, Rb^Gvs, Rb^Gvs, Gg, Gg, Gs^Fms, Gs^Fms, Gg, Gg, Rrc, Rrc, Gg, Gg, Gg, Gg, Gg, Gg, Gg, Rb^Gvs, Rb^Gvs, Rb^Gvs, Rb^Gvs, Gg, Gg, Gg, Gg, Rrc, Rrc, Gg, Rrc, Rrc, Gg, Wwg, Wwg, Gs^Fms, Gs^Fms, Gs^Fms, Gs^Fms, Gs^Fms, Gg, Gg, Gg, Gll^Fp, Gll^Fp, Gs^Fds, Gll^Fp, Gg, Gg, Gg, Gs^Fms, Rrc, Rrc, Gs^Fms, Gs^Fms, Gs^Fms, Gs^Fms, Gg, Gg, Gg, Gg
Gg, Gg, Gg, Gg, Rb^Gvs, Rb^Gvs, Rb^Gvs, Rb^Gvs, Rb^Gvs, Gs^Fms, Gs^Fms, Gs^Fms, Gs^Fms, Rrc, Gs^Fms, Gs^Fms, Gg, Wwg, Wwg, Gg, Gg, Gg, Gg, Rb^Gvs, Gg, Gg, Gg, Gs^Fms, Gs^Fms, Gs^Fms, Gs^Fms, Gg, Gg, Rrc, Rrc, Gg, Gg, Gg, Rb^Gvs, Rb^Gvs, Rb^Gvs, Rb^Gvs, Rb^Gvs, Rb^Gvs, Rb^Gvs, Gg, Rrc, Rrc, Gg, Gg, Gg, Gg, Wwg, Wwg^Bsb\, Rrc, Gs^Fms, Gs^Fms, Gs^Fms, Gs^Fms, Gs^Fms, Gs^Fms, Gg, Gg, Gg, Gll^Fp, Gs^Fds, Gs^Fds, Gs^Fds, Gg, Gg, Gg, Gg, Rrc, Rrc, Gg, Gs^Fms, Gll^Fp, Gll^Fp, Gll^Fp, Gg, Gg, Gg
Gg, Gg, Gg, Gg, Rb^Gvs, Rb^Gvs, Rb^Gvs, Rb^Gvs, Rb^Gvs, Gg, Gll^Fp, Gs^Fms, Gs^Fms, Rrc, Gs^Fms, Gs^Fms, Gg, Gg, Gg, Wwg, Wwg, Gg, Gg, Gg, Gg, Gg, Gg, Gs^Fms, Gs^Fms, Gs^Fms, Gs^Fms, Gs^Fms, Gg, Gg, Gg, Rrc, Rrc, Rb^Gvs, Rb^Gvs, Rb^Gvs, Rb^Gvs, Rb^Gvs, Rb^Gvs, Rb^Gvs, Rb^Gvs, Rrc, Rrc, Gg, Gg, Gg, Wwg, Wwg, Gg, Gg, Gs^Fms, Rrc, Rrc, Gs^Fms, Gs^Fms, Gs^Fms, Gs^Fms, Gs^Fms, Gg, Gg, Gll^Fp, Gs^Fds, Gs^Fds, Gs^Fds, Gs^Vh, Gg, Gll^Fp, Gll^Fp, Rrc, Gs^Fds, Gs^Fds, Gll^Fp, Gll^Fp, Gll^Fp, Gll^Fp, Gg, Gg, Gg
Wwg, Gg, Gg, Gg, Rb^Gvs, Rb^Gvs, Rb^Gvs, Rb^Gvs, Rb^Gvs, Gll^Fp, Gll^Fp, Gll^Fp, Gll^Fp, Rrc, Gg, Gs^Fms, Gg, Gg, Gg, Gg, Gg, Wwg, Wwg, Gg, Gg, Gg, Gg, Gs^Fms, Gs^Fms, Gs^Fms, Gs^Fms, Gs^Fms, Gg, Gg, Gg, Gg, Gg, Rrc, Rrc, Rb^Gvs, Rrc, Rrc, Rrc, Rb^Gvs, Rrc, Rrc, Gg, Gg, Wwg, Wwg, Gg, Gg, Gg, Gg, Gs^Fms, Gs^Fms, Gs^Fms, Rrc, Rrc, Rrc, Rrc, Rrc, Rrc, Rrc, Rrc, Rrc, Rrc, Rrc, Rrc, Gg, Gll^Fp, Rrc, Rrc, Gs^Fds, Gs^Fds, Gs^Fds, Gll^Fp, Gll^Fp, Gll^Fp, Gg, Gg, Gg
Gg, Wwg, Wwg, Gg, Rb^Gvs, Rb^Gvs, Rb^Gvs, Rb^Gvs, Rb^Gvs, Gll^Fp, Gll^Fp, Gll^Fp, Gll^Fp, Rrc, Gg, Gg, Gg, Gg, Gg, Gg, Gg, Gg, Gg, Wwg, Gg, Gg, Gg, Gg, Gg, Gs^Fms, Gg, Gg, Gg, Gg, Gg, Gg, Gg, Rb^Gvs, Rb^Gvs, Rrc, Ch, Kh, Ch, Rrc, Gg, Gg, Gg, Gg, Wwg, Gg, Gg, Gg, Gg, Gg, Gg, Gs^Fms, Gs^Fms, Gs^Fms, Gg, Gs^Fms, Gg, Gg, Rb^Gvs, Rb^Gvs, Rb^Gvs, Rb^Gvs, Rb^Gvs, Gg, Rb^Gvs, Rrc, Rrc, Rrc, Gll^Fp, Gs^Fds, Gs^Fds, Gs^Fds, Gg, Gll^Fp, Gg, Gg, Gg, Gg
Gg, Wwg, Wwg, Gg, Gg, Rb^Gvs, Rb^Gvs, Rb^Gvs, Rb^Gvs, Gll^Fp, Gll^Fp, Gll^Fp, Gll^Fp, Rrc, Rrc, Gll^Fp, Gg, Gg, Gg, Gg, Gg, Gg, Gs^Fms, Wwg, Wwg, Gg, Ce, Ce, 4 Ke, Gg, Gg, Gg, Gg, Gg, Gg, Gg, Gg, Gg, Gg, Rrc, Rrc, Ch, Rrc, Rrc, Gg, Gg, Wwg, Wwg, Gg, Gg, Gg, Gg, Gg, Gg, Gg, Gg, Gg, Gg, Gg, Gg, Gg, Rb^Gvs, Rb^Gvs, Rb^Gvs, Rb^Gvs, Rb^Gvs, Rb^Gvs, Rb^Gvs, Rb^Gvs, Rb^Gvs, Gg, Rrc, Gg, Gll^Fp, Gg, Gg, Gg, Gg, Gg, Gg, Gg, Gg
Gg, Gg, Gg, Wwg, Wwg, Rb^Gvs, Rb^Gvs, Rb^Gvs, Gg, Gg, Gg, Gll^Fp, Gll^Fp, Gll^Fp, Rrc, Gll^Fp, Gg, Gg, Gg, Gg, Gs^Fms, Gs^Fms, Gs^Fms, Gs^Fms, Gs^Fms, Wwg, Wwg, Gg, Gg, Ce, Gg, Gg, Gg, Gg, Rrc, Gg, Rrc, Rrc, Rrc, Rrc, Gg, Rrc, Gg, Gg, Gg, Gg, Wwg, Gg, Gg, Gg, Gg, Gg, Gg, Gg, Gg, Gg, Gg, Gg, Gg, Gg, Gg, Rb^Gvs, Rb^Gvs, Rb^Gvs, Rb^Gvs, Rb^Gvs, Rb^Gvs, Rb^Gvs, Rb^Gvs, Rb^Gvs, Gg, Rrc, Gg, Gg, Gg, Gg, Gg, Gg, Gg, Gg, Gg, Gg
Gg, Gg, Gg, Gg, Gg, Wwg, Wwg, Gg, Gg, Gg, Gg, Gg, Gg, Gll^Fp, Rrc, Gg, Rb^Gvs, Rb^Gvs, Rb^Gvs, Rb^Gvs, Rb^Gvs, Gs^Fms, Gs^Fms, Gs^Fms, Gs^Fms, Gs^Fms, Wwg, Wwg, Wwg, Gg, Gg, Gg, Rrc, Rrc, Rrc, Rrc, Gg, Gg, Gg, Gg, Gg, Rrc, Gg, Gg, Gg, Gg, Wwg, Gg, Gg, Gg, Gg, Gg, Gg, Gg, Gg, Gg, Gg, Gg, Gg, Gg, Wwg, Gg, Wwg, Gg, Wwg, Gg, Wwg, Gg, Wwg, Gg, Gg, Rrc, Gg, Gg, Gg, Gg, Gg, Gg, Gg, Gg, Gg, Gg
Rb^Gvs, Rb^Gvs, Rb^Gvs, Gg, Gg, Gg, Gg, Wwg, Wwg, Gg, Gg, Gg, Gg, Gg, Rrc, Gg, Rb^Gvs, Rb^Gvs, Rb^Gvs, Rb^Gvs, Rb^Gvs, Gs^Fms, Gs^Fms, Gs^Fms, Gs^Fms, Gs^Vh, Gg, Wwg, Wwg, Wwg, Wwg^Bsb/, Rrc, Gg, Gg, Gg, Gg, Gg, Gg, Gg, Gg, Gg, Rrc, Rrc, Gg, Gg, Gg, Wwg, Gg, Gg, Gg, Gg, Gg, Gg, Gg, Wwg, Gg, Wwg, Wwg, Wwg, Wwg, Rb^Gvs, Wwg, Gg, Wwg, Gg, Wwg, Wwg, Wwg, Wwg, Wwg, Wwg, Wwg^Bsb|, Wwg, Gg, Wwg, Gg, Gg, Gg, Gg, Gg, Gg, Gg
Rb^Gvs, Rb^Gvs, Rb^Gvs, Rb^Gvs, Rb^Gvs, Gg, Gg, Gg, Gg, Wwg, Wwg, Gg, Gg, Gs^Vh, Gg, Rrc, Rb^Gvs, Rb^Gvs, Rb^Gvs, Rb^Gvs, Rb^Gvs, Gs^Fms, Gs^Fms, Gs^Fms, Gs^Fms, Gs^Fms, Gg, Gg, Rrc, Wwg^Bsb/, Wwg, Wwg, Wwg, Gg, Gg, Gg, Gg, Gg, Gg, Gg, Gg, Rrc, Rrc, Gg, Gg, Gg, Wwg, Wwg, Wwg, Wwg, Wwg, Wwg, Wwg, Wwg, Wwg, Wwg, Wwg, Wwg, Rb^Gvs, Rb^Gvs, Rb^Gvs, Rb^Gvs, Rb^Gvs, Gg, Gg, Gg, Gg, Gg, Gg, Gg, Wwg, Wwg^Bsb|, Gg, Wwg, Gg, Wwg, Wwg, Gg, Gg, Gg, Gg, Gg
Gg, Rb^Gvs, Rb^Gvs, Rb^Gvs, Rb^Gvs, Rb^Gvs, Rb^Gvs, Gg, Gg, Gg, Gg, Gg, Gg, Gg, Gg, Rrc, Rb^Gvs, Rb^Gvs, Rb^Gvs, Rb^Gvs, Rb^Gvs, Gs^Fms, Gs^Fms, Gs^Fms, Gs^Fms, Gs^Fms, Rrc, Rrc, Gg, Gg, Gg, Gg, Gg, Wwg, Wwg, Wwg, Wwg, Gg, Gg, Gg, Gg, Rrc, Gg, Rrc, Wwg^Bsb\, Wwg, Gg, Gg, Gg, Gg, Gg, Gg, Gg, Gg, Gg, Gg, Gg, Gg, Rb^Gvs, Rb^Gvs, Rb^Gvs, Rb^Gvs, Rb^Gvs, Rb^Gvs, Rb^Gvs, Gg, Gg, Gg, Gg, Gg, Gg, Rrc, Gg, Gg, Gg, Gg, Gg, Wwg, Gg, Gg, Gg, Gg
Rrc, Rb^Gvs, Rb^Gvs, Rb^Gvs, Rb^Gvs, Rb^Gvs, Rb^Gvs, Rb^Gvs, Rb^Gvs, Gg, Gg, Gg, Gg, Gg, Gg, Rrc, Rrc, Rb^Gvs, Rb^Gvs, Rb^Gvs, Rb^Gvs, Gs^Fms, Rrc, Gs^Fms, Rrc, Rrc, Gg, Gg, Rb^Gvs, Gg, Gg, Gg, Gg, Gg, Gg, Wwg, Gg, Wwg, Wwg, Wwg, Wwg, Rrc, Wwg, Wwg, Gg, Rrc, Rr^Vhc, Rr^Vhc, Rr^Vhc, Gg, Gg, Gg, Gg, Gg, Gg, Gg, Gg, Rb^Gvs, Rb^Gvs, Rb^Gvs, Rb^Gvs, Rb^Gvs, Rb^Gvs, Rb^Gvs, Rb^Gvs, Gg, Gg, Gg, Gg, Gg, Rrc, Rrc, Gg, Gg, Gg, Gg, Gg, Wwg, Gg, Gg, Gg, Gg
Rrc, Rrc, Rrc, Rrc, Rrc, Rb^Gvs, Rb^Gvs, Rb^Gvs, Rb^Gvs, Rb^Gvs, Rb^Gvs, Gg, Gg, Gg, Rrc, Rrc, Rrc^Bsb/, Rrc, Rrc, Rb^Gvs, Rrc, Rrc, Rrc, Rrc, Gg, Gg, Gg, Rb^Gvs, Rb^Gvs, Rb^Gvs, Rb^Gvs, Gg, Gg, Gg, Gg, Gg, Gg, Gg, Gg, Gg, Gg, Wwg^Bsb|, Gg, Wwg, Wwg, Rr^Vhc, Wwg^Bsb/, Rr^Vhc, Rr^Vhc, Ch, Kh, Ch, Gg, Gg, Gg, Gg, Gg, Rb^Gvs, Rb^Gvs, Rb^Gvs, Rb^Gvs, Rb^Gvs, Rb^Gvs, Rb^Gvs, Gs^Fms, Gs^Vh, Gg, Gg, Gg, Gg, Rrc, Gg, Gg, Gg, Gg, Gg, Gg, Wwg, Ce, Ce, Ce, Gg
Rb^Gvs, Rb^Gvs, Rb^Gvs, Rb^Gvs, Rb^Gvs, Rrc, Rrc, Rb^Gvs, Rrc, Rrc, Rrc, Rb^Gvs, Rrc, Rrc, Rrc, Rrc^Bsb/, Rrc, Rrc, Rb^Gvs, Rrc, Rb^Gvs, Gg, Gg, Gg, Gg, Gg, Gg, Rb^Gvs, Rb^Gvs, Rb^Gvs, Rb^Gvs, Rb^Gvs, Rb^Gvs, Gg, Gg, Gg, Gg, Gg, Gs^Fms, Gg, Gg, Rrc, Gg, Gg, Rr^Vhc, Wwg^Bsb/, Wwg, Wwg, Rr^Vhc, Ch, Gg, Rrc, Rrc, Gg, Gg, Gg, Gs^Fms, Gs^Fms, Gs^Fms, Gs^Fms, Gg, Rb^Gvs, Gg, Gs^Fms, Gs^Fms, Gs^Fms, Gs^Fms, Gg, Gll^Fp, Rrc, Gs^Fds, Gg, Gg, Gg, Gg, Gg, Wwg, Wwg, Ce, Ce, 1 Ke, Gg
Rb^Gvs, Rb^Gvs, Rb^Gvs, Rb^Gvs, Rb^Gvs, Rb^Gvs, Rb^Gvs, Rrc, Rb^Gvs, Rr^Vhc, Rr^Vhc, Rr^Vhc, Rr^Vhc, Rrc, Rb^Gvs, Gg, Rrc, Rb^Gvs, Rb^Gvs, Rb^Gvs, Rb^Gvs, Rb^Gvs, Gg, Gg, Gs^Fms, Gs^Fms, Gs^Fms, Gg, Gg, Rb^Gvs, Rb^Gvs, Rb^Gvs, Rb^Gvs, Rb^Gvs, Rb^Gvs, Gg, Gs^Fms, Gs^Fms, Gs^Fms, Gs^Fms, Gs^Fms, Rrc, Gs^Fms, Gg, Rr^Vhc, Rr^Vhc, Rr^Vhc, Wwg^Bsb/, Wwg, Rr^Vhc, Gg, Gg, Gg, Rrc, Rrc, Gg, Gs^Fms, Gs^Fms, Gs^Fms, Gs^Fms, Gg, Gg, Gg, Gs^Fms, Gs^Fms, Gs^Fms, Gs^Fds, Gg, Gll^Fp, Rrc, Gs^Fds, Gs^Fds, Gg, Gg, Gg, Gg, Wwg, Gg, Ce, Ce, Gg, Gg
Rb^Gvs, Rb^Gvs, Rb^Gvs, Rb^Gvs, Rb^Gvs, Rb^Gvs, Rb^Gvs, Rb^Gvs, Rb^Gvs, Rr^Vhc, Rr^Vhc, Rr^Vhc, Rr^Vhc, Ch, Ch, Gg, Gg, Rrc, Rb^Gvs, Rb^Gvs, Rb^Gvs, Rb^Gvs, Gg, Gg, Gs^Fms, Gs^Fms, Gs^Fms, Gs^Fms, Gs^Fms, Gg, Gg, Rb^Gvs, Rb^Gvs, Rb^Gvs, Rb^Gvs, Gg, Gs^Fms, Gs^Fms, Gs^Fms, Gs^Fms, Gs^Fms, Rrc, Gs^Fms, Gg, Gg, Gg, Rr^Vhc, Rr^Vhc, Rr^Vhc, Wwg, Wwg, Gg, Gg, Gg, Gg, Rrc, Rrc, Gs^Fms, Rrc, Gg, Gg, Gg, Gg, Gs^Fms, Gs^Fms, Gs^Fds, Gs^Fds, Gs^Fds, Rrc, Rrc, Gs^Fds, Gs^Fds, Gg, Gg, Gg, Gg, Wwg, Gg, Gg, Ce, Gg, Gg
Gg, Rb^Gvs, Rb^Gvs, Rb^Gvs, Rb^Gvs, Rb^Gvs, Rb^Gvs, Rb^Gvs, Rb^Gvs, Rr^Vhc, Rr^Vhc, Rr^Vhc, Ch, 2 Kh, Ch, Gg, Rb^Gvs, Rrc, Rb^Gvs, Rb^Gvs, Rb^Gvs, Gg, Gg, Gg, Gg, Gs^Fms, Gs^Fms, Gs^Fms, Gs^Fms, Gg, Rb^Gvs, Rb^Gvs, Rb^Gvs, Rb^Gvs, Rb^Gvs, Rb^Gvs, Rb^Gvs, Gs^Fms, Gs^Fms, Gs^Fms, Gs^Fms, Rrc, Rrc, Gg, Gg, Gg, Rrc, Rr^Vhc, Rr^Vhc, Rr^Vhc, Gg, Wwg, Wwg, Gg, Gg, Gg, Rb^Gvs, Rrc, Rrc, Gg, Gg, Gg, Gg, Gs^Fms, Gs^Fms, Gs^Fds, Gs^Fds, Gs^Fds, Rrc, Gs^Fds, Gs^Fds, Gs^Fds, Gs^Fds, Gg, Gg, Gg, Wwg, Gg, Gg, Gg, Gg, Gg
Gg, Gg, Gg, Rb^Gvs, Rb^Gvs, Rb^Gvs, Rb^Gvs, Rb^Gvs, Rb^Gvs, Rb^Gvs, Rb^Gvs, Rr^Vhc, Rr^Vhc, Ch, Rb^Gvs, Gg, Gg, Rrc, Rb^Gvs, Rb^Gvs, Gg, Gg, Gs^Fds, Gg, Gg, Gg, Gs^Fms, Gs^Fms, Gs^Fms, Gg, Rb^Gvs, Rb^Gvs, Rb^Gvs, Rb^Gvs, Rb^Gvs, Rb^Gvs, Rb^Gvs, Rb^Gvs, Rb^Gvs, Gs^Fms, Gg, Gg, Gg, Rrc, Rrc, Gg, Rrc, Rr^Vhc, Gg, Gg, Gg, Gg, Wwg, Gg, Gg, Rb^Gvs, Rb^Gvs, Rb^Gvs, Gg, Rrc, Rrc, Gg, Gg, Gs^Fms, Gs^Fms, Gs^Fms, Gs^Fms, Rrc, Rrc, Gs^Fds, Gs^Fds, Gs^Fds, Gs^Fds, Gs^Fds, Gg, Gg, Wwg, Gg, Gg, Gg, Gg, Gg
Wwg, Wwg, Gg, Gg, Gg, Rb^Gvs, Rb^Gvs, Rb^Gvs, Rb^Gvs, Rb^Gvs, Rb^Gvs, Rr^Vhc, Rb^Gvs, Rr^Vhc, Gg, Gg, Gg, Rrc, Rrc, Gg, Gs^Fds, Gs^Fds, Gs^Fds, Gs^Fds, Gll^Fp, Gg, Gs^Fms, Gs^Fms, Gs^Fms, Gg, Gg, Rb^Gvs, Rb^Gvs, Rb^Gvs, Rb^Gvs, Rb^Gvs, Rb^Gvs, Rb^Gvs, Rb^Gvs, Gg, Gg, Gg, Gs^Fms, Gg, Gs^Fms, Rrc, Rrc, Gg, Gg, Gg, Gg, Gg, Wwg, Gg, Gg, Rb^Gvs, Rb^Gvs, Rb^Gvs, Gs^Fms, Gs^Fms, Gs^Fms, Rrc, Gg, Gs^Fms, Gs^Fms, Gs^Fms, Gs^Fms, Rrc, Gll^Fp, Gs^Fds, Gs^Fds, Gs^Fds, Gs^Fds, Gs^Fds, Gg, Gg, Gg, Wwg, Gg, Gg, Gg, Gg
Gg, Wwg, Wwg, Gg, Gg, Gg, Gg, Rb^Gvs, Rb^Gvs, Rb^Gvs, Rb^Gvs, Rrc, Rb^Gvs, Gg, Gg, Gg, Gg, Gg, Gg, Rrc, Rrc, Rrc, Rrc, Gs^Fds, Gll^Fp, Gs^Fms, Gs^Fms, Gs^Fms, Gs^Fms, Gg, Gg, Gg, Gg, Rb^Gvs, Rb^Gvs, Rb^Gvs, Rb^Gvs, Rb^Gvs, Gg, Gg, Gs^Fms, Gs^Fms, Gs^Fms, Gs^Fms, Gs^Fms, Gs^Fms, Rrc, Gg, Gs^Fds, Gll^Fp, Gll^Fp, Gg, Gg, Wwg, Gg, Rb^Gvs, Rb^Gvs, Rb^Gvs, Gs^Fms, Gs^Fms, Gs^Fms, Rrc, Rrc, Gg, Gg, Gs^Fms, Gg, Rrc, Gg, Gll^Fp, Gg, Gg, Gg, Gg, Gg, Gg, Gg, Wwg, Gg, Gg, Gg, Gg
Gg, Gg, Wwg, Wwg, Gg, Gg, Gg, Gg, Gg, Gg, Gs^Vh, Rrc, Gg, Gg, Gg, Gg, Gg, Gg, Gll^Fp, Gs^Fds, Gs^Fds, Rrc, Rrc, Rrc, Rrc, Gs^Fms, Gs^Fms, Gs^Fms, Rb^Gvs, Rb^Gvs, Rb^Gvs, Gg, Gs^Fms, Gs^Fms, Gs^Fms, Rb^Gvs, Gg, Gg, Gg, Gg, Gs^Fms, Gs^Fms, Gs^Fms, Gs^Fms, Gs^Fms, Rrc, Gs^Fms, Gs^Fds, Gs^Fds, Gs^Fds, Gs^Fds, Gg, Gg, Wwg, Gg, Rb^Gvs, Rb^Gvs, Rb^Gvs, Rb^Gvs, Gs^Fms, Gg, Gg, Rrc, Gg, Gg, Gg, Rrc, Rrc, Gg, Gg, Gg, Gg, Rb^Gvs, Gg, Gg, Gg, Gg, Wwg, Wwg, Gg, Gg, Gg
Gg, Gg, Gg, Wwg, Wwg, Gg, Gg, Gg, Gg, Gg, Rrc, Rrc, Gg, Gg, Gg, Gg, Rb^Gvs, Gg, Gll^Fp, Gs^Fds, Gs^Fds, Gs^Fds, Gg, Gg, Gg, Rrc, Rrc, Gg, Rrc, Rb^Gvs, Rb^Gvs, Gg, Gs^Fms, Gs^Fms, Gs^Fms, Gg, Gg, Gg, Gg, Gs^Fms, Gs^Fms, Gs^Fms, Gs^Fms, Gs^Fms, Rrc, Rrc, Gs^Fms, Gs^Fds, Gs^Fds, Gs^Fds, Gs^Fds, Gll^Fp, Gg, Wwg, Wwg, Rb^Gvs, Rb^Gvs, Rb^Gvs, Rb^Gvs, Rb^Gvs, Gg, Gg, Rrc, Rrc, Rrc, Rrc, Rrc, Gg, Gg, Gg, Rb^Gvs, Rb^Gvs, Rb^Gvs, Rb^Gvs, Rb^Gvs, Gg, Gg, Gg, Wwg, Gg, Gg, Gg
Gg, Gg, Gg, Gg, Gg, Wwg, Wwg, Gg, Gg, Gg, Rrc, Gg, Gg, Gg, Gg, Rb^Gvs, Rb^Gvs, Rb^Gvs, Rb^Gvs, Gll^Fp, Gg, Gg, Gg, Gg, Gs^Fms, Gg, Gg, Rrc, Rrc, Rrc, Rrc, Gg, Gg, Gs^Fms, Rb^Gvs, Gg, Gg, Gg, Gg, Gs^Fms, Gs^Fms, Gs^Fms, Gs^Fms, Gs^Fms, Rrc, Rrc, Gs^Fms, Gs^Fms, Gll^Fp, Gs^Fds, Gll^Fp, Gll^Fp, Gg, Wwg, Wwg, Rb^Gvs, Rb^Gvs, Rb^Gvs, Rb^Gvs, Rb^Gvs, Gg, Gg, Rrc, Rrc, Gll^Fp, Gll^Fp, Rrc, Gg, Gg, Gg, Rb^Gvs, Rb^Gvs, Rb^Gvs, Rb^Gvs, Rb^Gvs, Rb^Gvs, Gg, Gg, Wwg, Gg, Gg, Gg
Gg, Gg, Gg, Gg, Gg, Gg, Gg, Wwg, Wwg, Gg, Rrc, Gs^Fms, Gs^Fms, Gg, Rb^Gvs, Rb^Gvs, Rb^Gvs, Rb^Gvs, Rb^Gvs, Gg, Gg, Gg, Gs^Fms, Gs^Fms, Gs^Fms, Gs^Fms, Gg, Gg, Rb^Gvs, Rb^Gvs, Rb^Gvs, Rrc, Rrc, Rrc, Rrc, Rb^Gvs, Rb^Gvs, Gg, Gg, Gg, Gs^Fms, Gs^Fms, Gs^Fms, Gs^Fms, Rrc, Gs^Fms, Gs^Fms, Gs^Fms, Gs^Fms, Gll^Fp, Gll^Fp, Gll^Fp, Gg, Wwg, Gg, Rb^Gvs, Rb^Gvs, Rb^Gvs, Rb^Gvs, Rb^Gvs, Gg, Gg, Rrc, Rrc, Rr^Vhc, Rr^Vhc, Gs^Fds, Gs^Fds, Gs^Fds, Gg, Rb^Gvs, Rb^Gvs, Rb^Gvs, Rb^Gvs, Rb^Gvs, Rb^Gvs, Gg, Gg, Wwg, Gg, Gg, Gg
Gg, Gg, Gg, Gg, Gg, Gg, Gg, Gg, Wwg, Wwg, Rrc, Gs^Fms, Gs^Fms, Gg, Rb^Gvs, Rb^Gvs, Rb^Gvs, Rb^Gvs, Rb^Gvs, Gg, Gg, Gs^Fms, Gs^Fms, Gs^Fms, Gs^Fms, Gs^Fms, Gg, Gg, Rb^Gvs, Rb^Gvs, Rb^Gvs, Gg, Gg, Rrc, Rrc, Rrc, Rrc, Rb^Gvs, Rb^Gvs, Gg, Gg, Gs^Fms, Gs^Fms, Rrc, Rrc, Gs^Fms, Gg, Gs^Fms, Gg, Gg, Gg, Gg, Gg, Wwg, Gg, Rb^Gvs, Rb^Gvs, Rb^Gvs, Gg, Gg, Gs^Fms, Gg, Rrc, Rrc, Rr^Vhc, Rr^Vhc, Rr^Vhc, Gs^Fds, Gs^Fds, Gll^Fp, Gg, Rb^Gvs, Rb^Gvs, Rb^Gvs, Rb^Gvs, Gg, Gg, Gg, Wwg, Gg, Gg, Gg
Rb^Gvs, Rb^Gvs, Rb^Gvs, Gg, Gg, Gg, Gg, Gg, Gs^Fms, Wwg, Wwg^Bsb|, Gs^Fms, Gg, Gg, Gg, Rb^Gvs, Rb^Gvs, Rb^Gvs, Rb^Gvs, Gg, Gg, Gs^Fms, Gs^Fms, Gs^Fms, Gs^Fms, Gs^Fms, Gg, Gg, Gg, Rb^Gvs, Gg, Gg, Gg, Rb^Gvs, Rb^Gvs, Rb^Gvs, Rb^Gvs, Rrc, Rrc, Rrc, Rrc, Rrc, Rrc^Bsb\, Rrc, Rrc, Gg, Gg, Gg, Gg, Gg, Gg, Gg, Gg, Wwg, Gg, Gs^Fms, Gs^Fms, Gg, Gs^Fms, Gs^Fms, Gs^Fms, Gs^Fms, Rrc, Rr^Vhc, Rr^Vhc, Rr^Vhc, Rr^Vhc, Gs^Fds, Gll^Fp, Gll^Fp, Gg, Gg, Gs^Vh, Rb^Gvs, Gg, Gg, Gg, Gg, Gg, Wwg, Gg, Gg
Rb^Gvs, Rb^Gvs, Rb^Gvs, Rb^Gvs, Rb^Gvs, Gg, Gg, Gs^Fms, Gs^Fms, Gs^Fms, Rrc, Wwg, Wwg, Gg, Gg, Gg, Gg, Rb^Gvs, Gg, Gg, Gg, Gg, Hh, Gs^Fms, Gs^Fms, Gs^Fms, Hh, Gg, Hh, Gg, Hh, Gg, Hh, Gg, Gg, Rb^Gvs, Rrc, Rrc, Rb^Gvs, Rb^Gvs, Rb^Gvs, Rrc, Rrc, Rrc^Bsb\, Rrc, Gs^Fds, Gs^Fds, Gll^Fp, Gll^Fp, Gg, Gg, Gg, Wwg, Wwg, Gg, Gs^Fms, Gs^Fms, Gs^Fms, Gs^Fms, Gs^Fms, Gs^Fms, Gs^Fms, Rrc, Rrc, Rr^Vhc, Rr^Vhc, Rr, Gs^Fms, Gs^Fms, Gg, Gg, Gg, Gg, Gg, Gg, Gg, Gg, Gg, Gg, Wwg, Wwg, Gg
Rb^Gvs, Rb^Gvs, Rb^Gvs, Rb^Gvs, Rb^Gvs, Rb^Gvs, Gg, Gs^Fms, Gs^Fms, Gg, Rrc, Gg, Gg, Wwg, Wwg, Gg, Gg, Gg, Hh, Hh, Hh, Hh, Hh, Hh, Hh, Hh, Hh, Hh, Hh, Hh, Hh, Hh, Rrc, Hh, Rrc, Rrc, Hh, Rb^Gvs, Rb^Gvs, Rb^Gvs, Rb^Gvs, Rb^Gvs, Rrc, Gg, Gs^Fds, Rrc, Rrc, Rrc, Rrc, Gg, Rrc, Gg, Wwg, Gg, Gg, Gs^Fms, Rrc, Gs^Fms, Rrc, Gs^Fms, Rrc, Rrc, Gs^Fms, Gs^Fms, Gs^Fms, Gs^Fms, Gs^Fms, Rr, Gs^Fms, Gs^Fms, Gs^Fms, Gs^Fms, Gs^Fms, Gg, Gg, Gg, Gg, Gg, Gg, Gg, Wwg, Gg
Rb^Gvs, Rb^Gvs, Rb^Gvs, Rb^Gvs, Rb^Gvs, Rb^Gvs, Rb^Gvs, Gg, Gg, Gg, Rrc, Gg, Gg, Gg, Gg, Wwg, Wwg, Hh, Hh, Hh, Hh, Hh, Hh, Hh, Hh, Hh, Hh, Hh, Rrc, Rrc, Rrc, Rrc, Hh, Rrc, Hh, Hh, Hh, Hh, Hh, Rb^Gvs, Rb^Gvs, Rrc, Gg, Gg, Gll^Fp, Gs^Fds, Gs^Fds, Rrc, Gg, Rrc, Rrc, Wwg^Bsb\, Rrc, Rrc, Rrc, Rrc, Gs^Fms, Rrc, Gs^Fms, Rrc, Gs^Fms, Gs^Fms, Gs^Fms, Gs^Fms, Gs^Fms, Gs^Fms, Gs^Fms, Rr, Rr, Gs^Fms, Gs^Fms, Gs^Fms, Gs^Fms, Gs^Fms, Gs^Fms, Gg, Gg, Gg, Gg, Wwg, Gg, Gg
Gs^Fms, Rb^Gvs, Rb^Gvs, Rb^Gvs, Rb^Gvs, Rb^Gvs, Rb^Gvs, Rb^Gvs, Gg, Gg, Rrc, Gg, Gg, Gg, Hh, Wwg, Wwg, Hh, Hh, Hh, Hh, Hh, Hh, Hh, Rrc, Hh, Rrc, Rrc, Hh, Rrc, Hh, Hh, Hh^Vhh, Hh, Hh, Hh, Hh, Hh, Hh, Hh, Rrc, Rrc, Gg, Gg, Gg, Gll^Fp, Gg, Gg, Gg, Gg, Wwg, Wwg, Gg, Gg, Rrc, Gg, Gs^Fms, Gs^Fms, Gs^Fms, Gs^Fms, Gs^Fms, Gs^Fms, Gs^Fms, Gs^Fms, Gs^Fms, Gs^Fms, Gs^Fms, Gs^Fms, Rr, Gs^Fms, Gs^Fms, Gs^Fms, Gs^Fms, Gs^Fms, Gs^Fms, Gs^Fms, Gg, Gg, Gg, Wwg, Gg, Gg
Gg, Gs^Fms, Gs^Fms, Gs^Fms, Gs^Fms, Rb^Gvs, Rb^Gvs, Rb^Gvs, Gg, Gg, Rrc, Gg, Hh, Hh, Hh, Hh, Hh, Wwg, Hh, Hh, Hh, Hh, Rrc, Rrc, Rrc, Rrc, Hh, Hh, Hh, Hh, Hh, Hh, Hh, Hh, Hh, Hh, Hh, Hh, Rrc, Rrc, Hh, Gg, Gg, Gg, Gg, Gg, Gg, Gg, Gg, Gg, Wwg, Gg, Gg, Gg, Rrc, Gg, Gg, Gs^Fms, Gs^Fms, Gs^Fms, Gs^Fms, Gs^Fms, Gs^Fms, Gs^Fms, Gs^Fms, Gs^Fms, Gs^Fms, Gs^Fms, Gs^Fms, Rr, Rr, Gs^Fms, Gs^Fms, Gs^Fms, Gs^Fms, Gs^Fms, Gs^Fms, Gg, Gg, Gg, Gg, Gg
Gg, Gs^Fms, Gs^Fms, Gs^Fms, Gs^Fms, Gs^Fms, Gs^Fms, Gg, Gg, Gg, Rrc, Hh, Hh, Hh, Hh, Hh, Hh, Hh, Hh, Hh, Rrc, Rrc, Hh, Hh, Hh, Hh, Hh, Hh, Hh, Hh, Hh, Hh, Hh, Hh, Hh, Hh, Rrc, Rrc, Hh, Rrc, Rrc, Gg, Gg, Gg, Gg, Gg, Gg, Gg, Gg, Wwg, Gg, Wwg, Wwg, Gg, Rrc, Gg, Gg, Gg, Gg, Gg, Gg, Gs^Fms, Gs^Fms, Gs^Fms, Gs^Fms, Gs^Fms, Gs^Fms, Gs^Fms, Gs^Fms, Gs^Fms, Rr, Rr, Gs^Fms, Gs^Fms, Gs^Fms, Gs^Fms, Gs^Fms, Gg, Gg, Gg, Gg, Gg
Gg, Gg, Gg, Gs^Fms, Gs^Fms, Gs^Fms, Gs^Fms, Gg, Gg, Gg, Rrc, Hh, Hh, Hh, Hh, Hh, Hh, Hh, Rrc, Rrc, Hh, Hh, Hh, Hh, Hh, Hh, Hh, Hh, Hh, Hh, Hh, Hh, Hh, Hh, Rrc, Rrc, Hh, Hh, Hh, Hh, Hh, Rrc, Gg, Gg, Gg, Gg, Gg, Gg, Wwg, Wwg, Gg, Gg, Gg, Wwg, Wwg^Bsb|, Wwg, Wwg, Gg, Gg, Gg, Gg, Gg, Gg, Gs^Vh, Gg, Gg, Gg, Gs^Fms, Gs^Fms, Gs^Fms, Gs^Fms, Rr, Rr, Gs^Fms, Gs^Fms, Gs^Fms, Gs^Fms, Gg, Gg, Gg, Gg, Gg
Gg, Gg, Gll^Fp, Gll^Fp, Gll^Fp, Gll^Fp, Gll^Fp, Gg, Gs^Vh, Gg, Rrc, Hh, Hh, Hh, Gg, Hh, Rrc, Rrc, Hh, Hh, Hh, Hh, Hh, Hh, Hh, Hh, Hh, Hh, Hh, Hh, Hh, Hh, Rrc, Rrc, Hh, Hh, Hh, Hh, Hh, Hh, Hh, Rrc, Rrc, Gg, Gg, Gg, Gg, Gg, Wwg, Gg, Gg, Gg, Gg, Gg, Rrc, Wwg, Gg, Wwg, Wwg, Gg, Gg, Gg, Gg, Gg, Gg, Gg, Gg, Gg, Gg, Gs^Fms, Gs^Fms, Gs^Fms, Gs^Fms, Rr, Rr, Gs^Fms, Gs^Fms, Gg, Gg, Gg, Gg, Gg
Rrc, Rrc, Rrc, Rrc, Rrc, Gll^Fp, Rrc, Gg, Rrc, Gg, Gg, Rr^Vhc, Rr^Vhc, Hh, Rrc, Rrc, Hh, Hh, Hh, Hh, Hh, Hh, Hh, Hh, Hh, Hh, Hh, Hh, Rr^Vhc, Rr^Vhc, Rr^Vhc, Rr^Vhc, Hh, Hh, Hh, Hh, Hh, Hh, Hh, Hh, Hh, Hh, Hh, Rrc, Rrc, Gg, Gg, Wwg, Gg, Gg, Gg, Gg, Gg, Gg, Rrc, Rb^Gvs, Rb^Gvs, Gg, Gg, Wwg, Wwg, Gg, Gg, Gg, Gg, Gg, Gg, Gg, Gg, Gg, Gg, Gg, Gg, Gs^Fms, Gg, Rr, Rr, Gg, Gg, Gg, Gg, Gg
Gg, Gll^Fp, Gll^Fp, Gll^Fp, Gll^Fp, Rrc, Gll^Fp, Rrc, Gg, Rrc, Rrc, Rr^Vhc, Rr^Vhc, Rr^Vhc, Hh, Hh^Vhh, Hh, Hh, Hh, Hh, Hh, Hh, Hh, Hh, Hh, Hh, Hh, Hh, Hh, Rr^Vhc, Rr^Vhc, Rr^Vhc, Hh, Hh, Hh, Hh, Hh, Hh, Hh, Hh, Hh, Hh, Hh, Gg, Gg, Rrc, Wwg^Bsb\, Wwg, Gg, Gg, Gg, Gg, Gg, Rb^Gvs, Rrc, Rb^Gvs, Rb^Gvs, Rb^Gvs, Rb^Gvs, Gg, Gg, Wwg, Wwg, Gg, Gg, Gg, Gg, Gg, Gg, Gg, Gg, Gg, Gg, Gg, Gg, Gg, Gg, Rr, Rr, Rr, Rr, Gg
Gg, Gg, Gg, Gll^Fp, Gg, Gll^Fp, Gg, Gg, Gg, Gg, Gg, Rr^Vhc, Rr^Vhc, Rr^Vhc, Hh, Hh, Hh, Hh, Hh, Hh, Hh, Hh, Hh, Hh, Hh, Hh, Hh, Hh, Rrc, Rrc, Hh, Hh, Hh, Hh, Hh, Hh, Hh, Hh, Hh, Hh, Hh, Hh, Hh, Gg, Wwg, Wwg, Wwg, Rrc, Rrc, Gg, Hh, Gg, Gg, Rrc, Rrc, Rb^Gvs, Rb^Gvs, Rb^Gvs, Rb^Gvs, Rb^Gvs, Rb^Gvs, Gg, Gg, Wwg, Wwg, Gg, Gg, Gg, Gg, Gg, Gg, Gg, Gg, Gg, Gs^Vh, Gg, Gg, Gg, Gg, Rr, Rr, Rr
Gg, Gg, Gg, Gg, Gg, Gg, Gg, Gg, Gg, Gg, Gg, Gg, Hh, Rrc, Rrc, Hh, Hh, Hh, Hh, Hh, Hh, Hh, Hh, Hh, Hh, Hh, Rrc, Rrc, Hh, Hh, Hh, Gs^Vh, Hh, Hh, Hh, Hh, Hh, Hh, Hh, Hh, Hh, Hh, Wwg, Wwg, Wwg, Wwg, Hh, Hh, Hh, Rrc, Rrc, Hh, Hh, Rrc, Hh, Rb^Gvs, Rb^Gvs, Rb^Gvs, Rb^Gvs, Rb^Gvs, Rb^Gvs, Gg, Gg, Gg, Gg, Wwg, Wwg, Gg, Gg, Gg, Gg, Gg, Gg, Gg, Gg, Gg, Gg, Gg, Gg, Gg, Gg, Gg
Gg, Gg, Gg, Gg, Gg, Gg, Gg, Gg, Gg, Gg, Hh, Hh, Hh, Hh, Hh, Rrc, Rrc, Hh, Ch, Ch, Ch, Hh, Hh, Hh, Rrc, Rrc, Hh, Hh, Hh, Hh, Hh, Hh, Hh, Hh, Hh, Hh, Hh, Hh, Hh, Hh, Wwg, Wwg, Hh, Wwg, Hh, Hh, Hh, Hh, Hh, Rrc, Rrc, Hh, Hh, Rrc, Hh, Hh, Hh, Rb^Gvs, Rb^Gvs, Rb^Gvs, Gg, Gg, Gg, Gg, Gg, Gg, Gg, Wwg, Gg, Gg, Gg, Gg, Gg, Gg, Gg, Gg, Gg, Gg, Gg, Gg, Gg, Gg
Gg, Gg, Gg, Gg, Gg, Gg, Gg, Gg, Hh, Hh, Hh, Hh, Hh, Hh, Hh, Hh, Rrc, Rrc, Ch, Kh, Hh, Hh, Rrc, Rrc, Hh, Hh, Hh, Hh, Hh, Hh, Hh, Hh, Hh, Hh, Hh, Hh, Wwg, Wwg, Wwg, Wwg, Hh, Hh, Hh, Hh, Hh, Hh, Hh, Hh, Hh, Hh, Hh, Rrc, Hh, Rrc, Hh, Hh, Hh, Hh, Hh, Gg, Gg, Gg, Gg, Gg, Gg, Gg, Gg, Wwg, Gg, Gg, Gg, Gg, Gg, Gg, Gg, Gg, Gg, Gg, Gg, Gg, Gg, Gg
Gg, Gg, Gg, Gg, Hh, Gg, Hh, Gg, Hh, Hh, Hh, Hh, Hh, Hh, Hh, Hh, Hh, Rrc, Rrc, Hh, Hh, Rrc, Rrc, Hh, Hh, Hh, Hh, Hh, Hh, Hh, Hh, Hh, Hh, Hh, Wwg, Wwg, Hh, Wwg, Hh, Hh, Hh, Hh, Hh, Hh, Hh, Hh, Hh, Hh, Hh, Hh, Hh, Rr^Vhc, Rr^Vhc, Rr^Vhc, Rr^Vhc, Hh, Rr, Hh, Hh, Hh, Hh, Gg, Gg, Gg, Gg, Gg, Gg, Wwg, Gg, Gg, Gg, Gg, Gg, Gg, Gg, Gg, Gg, Gg, Gg, Gg, Gg, Gg
Gg, Gg, Hh, Hh, Hh, Hh, Hh, Hh, Hh, Hh, Hh, Hh, Hh, Hh, Hh, Hh, Hh, Hh, Rr^Vhc, Rr^Vhc, Rr^Vhc, Rrc, Hh, Hh, Hh, Hh, Hh, Hh, Hh, Hh, Wwg, Wwg, Wwg, Wwg, Hh, Hh, Hh, Hh, Hh, Hh, Hh, Hh, Hh, Hh, Hh, Hh, Hh, Hh, Hh, Hh, Rr^Vhc, Rr^Vhc, Rr^Vhc, Rr^Vhc, Rr^Vhc, Rr, Rr, Rr, Rr, Rr, Rr, Hh, Gg, Gg, Wwg, Gg, Wwg, Wwg, Gg, Gg, Gg, Gg, Gg, Gg, Gg, Gg, Gg, Gg, Gg, Gg, Gg, Gg
Hh, Hh, Hh, Hh, Hh, Hh, Hh, Hh, Hh^Vhh, Hh, Hh, Hh, Hh, Hh, Hh, Hh, Hh, Hh, Rr^Vhc, Rr^Vhc, Rr^Vhc, Rr^Vhc, Hh, Hh, Hh, Hh, Wwg, Wwg, Wwg, Wwg, Hh, Hh, Hh, Hh, Hh, Hh, Hh, Hh, Hh, Hh, Hh, Hh, Hh, Hh, Hh, Hh, Hh^Vhh, Hh, Rrc, Rrc, Hh, Rr^Vhc, Rr^Vhc, Rr^Vhc, Hh, Hh, Hh, Hh, Hh, Hh, Hh, Rr, Wwg^Bsb\, Wwg, Hh, Wwg, Gg, Gg, Gg, Gg, Gg, Gg, Hh, Hh, Hh, Hh, Hh, Gg, Gg, Gg, Gg, Gg
Hh, Hh, Hh, Hh, Hh, Hh, Hh, Hh, Hh, Hh, Hh, Hh, Hh, Hh, Hh, Hh, Hh, Hh, Rr^Vhc, Rr^Vhc, Wwg^Bsb|, Rr^Vhc, Wwg, Wwg, Wwg, Wwg, Hh, Wwg, Hh, Hh, Hh, Hh, Hh, Hh, Hh, Hh, Hh, Hh, Hh, Hh, Hh, Hh, Hh, Hh, Rrc, Rrc, Rrc, Rrc, Hh, Hh, Hh, Hh, Hh, Hh, Hh, Hh, Hh, Hh, Hh, Hh, Hh, Wwg, Hh, Rr, Rr, Hh, Hh, Gg, Hh, Gg, Hh, Hh, Hh, Hh, Hh, Hh, Hh, Hh, Hh, Gg, Gg, Gg
Hh, Hh, Hh, Hh, Hh, Hh, Hh, Hh, Wwg, Hh, Wwg, Hh, Wwg, Hh, Wwg, Wwg, Wwg, Wwg, Wwg, Wwg, Rr^Vhc, Wwg, Hh, Hh, Hh, Hh, Hh, Hh, Hh, Hh, Hh^Vhh, Hh, Hh, Hh, Hh, Hh, Hh, Hh, Rrc, Hh, Rrc, Rrc, Rrc, Rrc, Hh, Rrc, Hh, Hh, Hh, Hh, Hh, Hh, Hh, Hh, Hh, Hh, Hh, Hh, Hh, Hh^Vhh, Hh, Wwg, Hh, Hh, Hh, Rr, Rr, Gg, Rr, Hh, Hh, Hh, Hh, Hh, Hh, Hh, Hh, Hh, Hh, Hh, Hh, Gg
Hh, Hh, Hh, Hh, Hh, Hh, Wwg, Wwg, Wwg, Wwg, Mm, Wwg, Hh, Wwg, Hh, Wwg, Hh, Hh, Hh, Rr^Vhc, Hh, Rrc, Rrc, Rrc, Rrc, Hh, Hh, Hh, Hh, Hh, Rrc, Hh, Rrc, Hh, Rrc, Rrc, Rrc, Rrc, Rrc, Rrc, Hh, Rrc, Hh, Hh, Hh, Hh, Hh, Hh, Hh, Hh, Hh, Hh, Hh, Hh, Hh, Hh, Hh, Hh, Hh, Hh, Hh, Wwg, Wwg, Hh, Hh, Hh, Hh, Rr, Hh, Rr, Rr, Hh, Rr, Hh, Hh, Hh, Hh, Hh, Hh, Hh, Hh, Gg
Gg, Hh, Mm, Gg, Wwg, Wwg, Mm, Mm, Mm, Mm, Mm, Mm, Mm, Mm, Mm, Hh, Mm, Hh, Mm, Rrc, Mm, Hh, Hh, Rrc, Hh, Rrc, Rrc, Rrc, Rrc, Rrc, Hh, Rrc, Hh, Rrc, Hh, Hh, Hh, Hh, Hh, Hh, Mm, Hh, Mm, Mm, Mm, Mm, Mm, Mm, Mm, Hh, Hh, Hh, Hh, Hh, Hh, Hh, Hh, Hh, Hh, Hh, Hh, Hh, Wwg, Wwg, Wwg, Hh, Hh, Hh, Hh, Hh, Hh, Rr, Hh, Rr, Rr, Hh, Rr, Hh, Hh, Hh, Hh, Hh
Mm, Mm, Mm, Wwg, Mm, Mm, Mm^Xm, Mm, Mm, Mm, Mm, Mm, Mm, Mm, Mm, Mm, Mm, Mm, Mm, Rrc, Mm, Mm, Mm, Mm, Mm, Hh, Mm, Rrc, Mm, Rrc, Rrc, Rrc, Rrc, Mm, Rrc, Mm, Mm, Mm, Mm, Mm, Mm, Mm, Mm, Mm, Mm, Mm, Mm, Mm, Mm, Mm, Mm, Mm, Mm, Hh, Hh, Hh, Hh, Hh, Hh, Hh, Hh, Hh, Hh, Wwg, Wwg, Hh, Hh, Hh, Hh, Hh, Hh, Hh, Hh, Hh, Hh, Rr, Rr, Rr, Rr, Hh, Hh, Hh
Mm, Mm, Wwg, Wwg, Mm, Mm, Mm, Mm, Ms, Ms^Xm, Ms, Mm, Mm, Mm, Mm, Mm, Mm, Mm, Mm, Rrc, Mm, Mm, Mm, Mm, Mm, Mm, Mm, Mm, Mm, Mm, Mm, Mm, Mm, Rrc, Rrc, Rrc, Rrc, Ms^Xm, Ms, Mm, Mm, Mm, Mm, Mm, Mm, Mm, Mm, Mm, Mm, Mm, Mm, Mm, Mm, Mm, Mm, Mm, Mm, Hh, Mm, Hh, Hh, Hh, Hh, Hh, Hh, Wwg, Wwg, Hh, Hh, Hh, Hh, Hh, Hh, Hh, Hh, Hh, Hh, Rr, Hh, Rr, Rr, Hh
Mm, Mm, Mm, Wwg, Mm, Mm, Mm, Mm, Ms, Ms, Ms, Mm, Mm, Mm, Mm, Mm, Mm, Mm, Mm, Rrc, Mm, Mm, Mm, Mm, Mm, Mm, Mm, Mm, Mm, Mm, Mm, Mm, Mm, Mm, Mm, Mm, Ms, Rrc, Rrc, Mm, Mm, Mm, Mm, Mm, Mm, Mm, Mm, Mm, Mm, Mm, Mm, Mm, Mm, Mm, Mm, Mm, Mm, Mm, Mm, Mm, Mm, Mm, Mm, Hh, Hh, Hh, Hh, Wwg, Wwg, Hh, Wwg, Hh, Hh, Hh, Hh, Hh, Hh, Hh, Hh, Hh, Hh, Rr
Mm, Mm, Mm, Wwg, Wwg, Mm, Mm, Mm, Mm, Mm, Mm, Mm, Mm, Mm, Mm, Mm, Mm, Mm, Mm, Rrc, Rr^Vhc, Mm, Ms, Mm, Ms, Mm, Ms, Mm, Mm, Mm, Mm, Mm, Mm, Mm, Mm, Mm, Mm, Mm, Rrc, Mm, Mm, Mm, Mm, Mm, Mm, Mm, Mm, Mm, Mm, Mm, Mm, Mm, Mm, Mm, Mm, Mm, Mm, Mm, Mm, Mm, Mm, Mm, Mm, Hh, Hh, Hh, Hh, Hh, Hh, Wwg, Wwg, Wwg, Wwg, Hh, Hh, Hh, Hh, Hh, Hh, Hh, Hh, Hh
Mm, Mm, Mm, Mm, Wwg, Mm, Mm, Mm, Mm, Mm, Mm, Mm, Ms, Mm, Ms, Ms, Ms^Xm, Ms, Rr^Vhc, Rrc, Rr^Vhc, Ms, Ms, Ms, Ms^Xm, Ms, Ms, Ms, Ms, Mm, Mm, Mm, Mm, Mm, Mm, Mm, Mm, Mm, Mm, Rrc, Rrc, Mm^Xm, Mm, Mm, Mm, Mm, Mm, Mm, Mm, Mm, Mm, Mm, Mm, Mm, Mm, Mm, Mm, Mm, Mm, Mm, Mm, Mm, Mm, Mm, Mm, Hh, Hh, Hh, Hh, Hh, Hh, Wwg, Hh, Wwg, Hh, Hh, Hh, Hh, Hh, Hh, Hh, Hh
Mm, Mm, Mm, Mm, Mm, Mm, Mm, Mm, Mm, Mm, Ms, Ms, Ms, Ms, Ms, Ms, Ms, Ms, Ms, Rr^Vhc, Ms, Ms, Ms, Ms, Ms, Ms, Ms, Ms, Ms, Ms, Ms, Mm, Mm, Mm, Mm, Mm, Mm, Mm, Mm, Mm, Ch, Ch, Mm, Mm, Mm, Mm, Mm, Mm, Mm, Mm, Mm, Mm, Mm, Mm, Mm, Mm, Mm, Mm, Mm, Mm, Mm, Mm, Mm, Mm, Mm, Mm, Mm, Hh, Hh, Hh, Hh, Hh, Hh, Hh, Hh, Hh, Hh, Hh, Hh, Hh, Hh, Hh
Mm, Mm, Mm, Mm, Mm, Mm, Mm, Mm, Ms, Ms, Ms, Ms, Ms, Ms, Ms, Ms, Ms, Ms, Mm, Ms, Mm, Ms, Mm, Ms, Mm, Ms, Mm, Ms, Ms, Ms, Ms, Mm, Mm, Mm, Mm, Mm, Mm, Mm, Mm, Ch, Ms, 3 Kh, Ms, Mm, Ms, Mm, Ms, Mm, Ms, Mm, Ms, Mm, Ms, Mm, Ms, Mm, Mm, Mm, Mm, Mm, Mm, Mm, Mm, Mm, Mm, Gg, Mm, Mm, Mm, Hh, Hh, Hh, Hh, Hh, Hh, Hh, Hh, Hh, Hh, Hh, Hh, Hh
Mm, Mm, Mm, Mm, Mm, Mm, Mm, Ms, Ms, Ms, Ms, Ms, Mm, Ms, Mm, Mm, Mm, Mm, Mm, Mm, Mm, Mm, Mm, Mm, Mm, Mm, Mm, Mm, Mm, Ms, Mm, Mm, Mm, Mm, Mm, Mm, Mm, Mm, Mm, Ms, Ms, Ms, Ms, Ms, Ms, Ms, Ms^Xm, Ms, Ms, Ms, Ms, Ms, Ms, Ms, Ms^Xm, Ms, Ms, Ms, Ms, Mm, Mm, Mm, Mm, Mm, Mm, Mm, Mm, Mm, Mm, Mm, Mm, Mm, Mm, Hh, Hh, Hh, Hh, Hh, Hh, Hh, Hh, Hh
Mm, Mm, Mm, Mm, Mm, Mm, Mm, Ms, Ms, Ms, Mm, Mm, Mm, Mm, Mm, Mm, Mm, Mm, Mm, Mm, Mm, Mm, Mm^Xm, Mm, Mm, Mm, Mm, Mm, Mm, Mm, Mm, Mm, Mm, Mm, Mm, Mm, Mm, Mm, Mm, Ms, Ms, Ms, Ms, Ms, Ms, Ms, Ms, Ms, Ms, Ms, Ms, Ms, Ms, Ms, Ms, Ms, Ms, Ms, Ms, Ms, Mm, Mm, Mm, Mm, Mm, Mm, Mm, Mm, Mm, Mm, Mm, Mm, Mm, Mm, Mm, Hh, Hh, Hh, Hh, Hh, Hh, Hh
Mm, Mm, Mm, Mm, Mm, Mm, Mm, Mm, Mm, Mm, Mm, Mm, Mm, Mm, Mm, Mm, Mm, Mm, Mm, Mm, Mm, Mm, Mm, Mm, Mm, Mm, Mm, Mm, Mm, Mm, Mm, Mm, Mm, Mm, Mm, Mm, Mm, Mm, Mm, Mm, Mm, Ms, Mm, Ms, Mm, Ms, Mm, Ms, Mm, Ms, Mm, Ms, Mm, Ms, Mm, Ms, Ms, Ms, Ms, Ms, Mm, Mm, Mm, Mm, Gg, Mm, Mm, Mm, Mm, Mm, Mm, Mm, Mm, Mm, Mm, Hh, Hh, Hh, Hh, Hh, Hh, Hh
